
Rk,Player,Pos,Age,Tm,G,GS,MP,FG,FGA,FG%,3P,3PA,3P%,2P,2PA,2P%,eFG%,FT,FTA,FT%,ORB,DRB,TRB,AST,STL,BLK,TOV,PF,PTS
1,Alex Abrines\abrinal01,SG,25,OKC,31,2,588,56,157,.357,41,127,.323,15,30,.500,.487,12,13,.923,5,43,48,20,17,6,14,53,165
2,Quincy Acy\acyqu01,PF,28,PHO,10,0,123,4,18,.222,2,15,.133,2,3,.667,.278,7,10,.700,3,22,25,8,1,4,4,24,17
3,Jaylen Adams\adamsja01,PG,22,ATL,34,1,428,38,110,.345,25,74,.338,13,36,.361,.459,7,9,.778,11,49,60,65,14,5,28,45,108
4,Steven Adams\adamsst01,C,25,OKC,80,80,2669,481,809,.595,0,2,.000,481,807,.596,.595,146,292,.500,391,369,760,124,117,76,135,204,1108
5,Bam Adebayo\adebaba01,C,21,MIA,82,28,1913,280,486,.576,3,15,.200,277,471,.588,.579,166,226,.735,165,432,597,184,71,65,121,203,729
6,Deng Adel\adelde01,SF,21,CLE,19,3,194,11,36,.306,6,23,.261,5,13,.385,.389,4,4,1.000,3,16,19,5,1,4,6,13,32
7,DeVaughn Akoon-Purcell\akoonde01,SG,25,DEN,7,0,22,3,10,.300,0,4,.000,3,6,.500,.300,1,2,.500,1,3,4,6,2,0,2,4,7
8,LaMarcus Aldridge\aldrila01,C,33,SAS,81,81,2687,684,1319,.519,10,42,.238,674,1277,.528,.522,349,412,.847,251,493,744,194,43,107,144,179,1727
9,Rawle Alkins\alkinra01,SG,21,CHI,10,1,120,13,39,.333,3,12,.250,10,27,.370,.372,8,12,.667,11,15,26,13,1,0,8,7,37
10,Grayson Allen\allengr01,SG,23,UTA,38,2,416,67,178,.376,32,99,.323,35,79,.443,.466,45,60,.750,3,20,23,25,6,6,33,47,211
11,Jarrett Allen\allenja01,C,20,BRK,80,80,2096,335,568,.590,6,45,.133,329,523,.629,.595,197,278,.709,191,481,672,110,43,120,103,184,873
12,Kadeem Allen\allenka01,SG,26,NYK,19,1,416,65,141,.461,17,36,.472,48,105,.457,.521,42,54,.778,8,43,51,76,16,4,26,46,189
13,Al-Farouq Aminu\aminual01,PF,28,POR,81,81,2292,257,593,.433,96,280,.343,161,313,.514,.514,150,173,.867,112,498,610,104,68,33,72,143,760
14,Justin Anderson\anderju01,SF,25,ATL,48,4,463,64,157,.408,24,77,.312,40,80,.500,.484,26,35,.743,24,60,84,23,22,13,23,48,178
15,Kyle Anderson\anderky01,SF,25,MEM,43,40,1281,150,276,.543,9,34,.265,141,242,.583,.560,37,64,.578,48,203,251,128,54,37,58,112,346
16,Ryan Anderson\anderry01,PF,30,TOT,25,8,322,21,69,.304,9,40,.225,12,29,.414,.370,12,16,.750,18,36,54,19,4,1,14,25,63
17,Ike Anigbogu\anigbik01,C,20,IND,3,0,6,0,3,.000,0,0,,0,3,.000,.000,0,0,,1,2,3,1,0,1,1,0,0
18,Giannis Antetokounmpo\antetgi01,PF,24,MIL,72,72,2358,721,1247,.578,52,203,.256,669,1044,.641,.599,500,686,.729,159,739,898,424,92,110,268,232,1994
19,Kostas Antetokounmpo\antetko01,PF,21,DAL,2,0,11,0,3,.000,0,0,,0,3,.000,.000,2,4,.500,0,1,1,0,2,0,1,0,2
20,Carmelo Anthony\anthoca01,PF,34,HOU,10,2,294,49,121,.405,21,64,.328,28,57,.491,.492,15,22,.682,9,45,54,5,4,7,8,32,134
21,OG Anunoby\anunoog01,SF,21,TOR,67,6,1352,183,404,.453,67,202,.332,116,202,.574,.536,36,62,.581,58,139,197,47,46,22,55,140,469
22,Ryan Arcidiacono\arcidry01,PG,24,CHI,81,32,1961,187,418,.447,81,217,.373,106,201,.527,.544,89,102,.873,27,192,219,269,65,4,63,171,544
23,Trevor Ariza\arizatr01,SF,33,TOT,69,69,2349,294,736,.399,145,434,.334,149,302,.493,.498,130,164,.793,50,321,371,252,91,21,106,130,863
24,D.J. Augustin\augusdj01,PG,31,ORL,81,81,2269,318,677,.470,131,311,.421,187,366,.511,.566,181,209,.866,41,162,203,426,52,4,128,115,948
25,Deandre Ayton\aytonde01,C,20,PHO,71,70,2183,509,870,.585,0,4,.000,509,866,.588,.585,141,189,.746,223,506,729,125,61,67,126,209,1159
26,Dwayne Bacon\bacondw01,SG,23,CHO,43,13,759,122,257,.475,38,87,.437,84,170,.494,.549,34,46,.739,8,81,89,47,12,5,18,72,316
27,Marvin Bagley\baglema01,PF,19,SAC,62,4,1567,356,706,.504,30,96,.313,326,610,.534,.525,181,262,.691,162,309,471,62,33,59,98,120,923
28,Ron Baker\bakerro01,SG,25,TOT,15,0,152,4,20,.200,1,13,.077,3,7,.429,.225,5,6,.833,1,10,11,15,6,1,5,18,14
29,Wade Baldwin\baldwwa01,PG,22,POR,16,0,94,10,33,.303,2,9,.222,8,24,.333,.333,8,11,.727,2,13,15,12,1,2,14,11,30
30,Lonzo Ball\balllo01,PG,21,LAL,47,45,1423,185,456,.406,75,228,.329,110,228,.482,.488,20,48,.417,54,197,251,255,69,19,103,114,465
31,Mohamed Bamba\bambamo01,C,20,ORL,47,1,766,117,243,.481,21,70,.300,96,173,.555,.525,37,63,.587,64,169,233,39,13,64,43,102,292
32,J.J. Barea\bareajo01,PG,34,DAL,38,0,752,161,385,.418,38,128,.297,123,257,.479,.468,55,78,.705,13,82,95,211,22,1,72,50,415
33,Harrison Barnes\barneha02,PF-SF,26,TOT,77,77,2533,431,1027,.420,174,441,.395,257,586,.439,.504,229,278,.824,57,304,361,115,50,13,98,122,1265
34,Will Barton\bartowi01,SG,28,DEN,43,38,1189,185,460,.402,67,196,.342,118,264,.447,.475,57,74,.770,32,167,199,124,18,22,65,82,494
35,Keita Bates-Diop\bateske01,SF,23,MIN,30,3,503,60,142,.423,13,52,.250,47,90,.522,.468,18,28,.643,16,67,83,17,18,14,14,29,151
36,Nicolas Batum\batumni01,SF,30,CHO,75,72,2354,253,562,.450,116,298,.389,137,264,.519,.553,77,89,.865,71,319,390,247,71,43,117,140,699
37,Jerryd Bayless\bayleje01,PG,30,MIN,34,6,657,82,230,.357,29,98,.296,53,132,.402,.420,16,28,.571,11,51,62,119,18,2,32,56,209
38,Aron Baynes\baynear01,C,32,BOS,51,18,821,105,223,.471,21,61,.344,84,162,.519,.518,53,62,.855,88,152,240,57,12,34,40,125,284
39,Kent Bazemore\bazemke01,SG,29,ATL,67,35,1643,278,691,.402,96,300,.320,182,391,.465,.472,127,175,.726,37,224,261,152,89,42,121,170,779
40,Bradley Beal\bealbr01,SG,25,WAS,82,82,3028,764,1609,.475,209,596,.351,555,1013,.548,.540,362,448,.808,89,322,411,448,121,58,224,226,2099
41,Malik Beasley\beaslma01,SG,22,DEN,81,18,1879,349,737,.474,163,405,.402,186,332,.560,.584,56,66,.848,35,165,200,97,55,10,55,116,917
42,Michael Beasley\beaslmi01,PF,30,LAL,26,2,277,75,153,.490,3,17,.176,72,136,.529,.500,28,39,.718,13,47,60,25,9,10,27,42,181
43,Marco Belinelli\belinma01,SG,32,SAS,79,1,1815,285,690,.413,147,395,.372,138,295,.468,.520,112,124,.903,16,182,198,132,35,8,72,121,829
44,Jordan Bell\belljo01,C,24,GSW,68,3,788,99,192,.516,0,2,.000,99,190,.521,.516,25,41,.610,55,129,184,76,20,51,42,80,223
45,DeAndre' Bembry\bembrde01,SG,24,ATL,82,15,1931,275,616,.446,50,173,.289,225,443,.508,.487,87,136,.640,54,304,358,202,105,41,142,190,687
46,Dragan Bender\bendedr01,PF,21,PHO,46,27,826,88,197,.447,22,101,.218,66,96,.688,.503,32,54,.593,34,149,183,56,18,22,37,90,230
47,Dairis Bertans\bertada02,SG,29,NOP,12,0,167,12,47,.255,10,34,.294,2,13,.154,.362,0,0,,2,7,9,10,1,0,2,7,34
48,Davis Bertans\bertada01,PF,26,SAS,76,12,1632,204,453,.450,145,338,.429,59,115,.513,.610,53,60,.883,23,241,264,100,35,33,43,133,606
49,Patrick Beverley\beverpa01,PG,30,LAC,78,49,2137,194,477,.407,112,282,.397,82,195,.421,.524,96,123,.780,76,312,388,300,67,43,85,265,596
50,Khem Birch\birchkh01,C,26,ORL,50,1,643,91,151,.603,0,1,.000,91,150,.607,.603,58,83,.699,79,111,190,38,18,29,20,72,240
51,Bismack Biyombo\biyombi01,C,26,CHO,54,32,783,89,156,.571,0,0,,89,156,.571,.571,58,91,.637,81,166,247,33,11,41,34,103,236
52,Nemanja Bjelica\bjeline01,PF,30,SAC,77,70,1788,284,593,.479,103,257,.401,181,336,.539,.566,70,92,.761,125,319,444,147,54,56,82,197,741
53,Antonio Blakeney\blakean01,SG,22,CHI,57,3,829,166,396,.419,36,91,.396,130,305,.426,.465,50,76,.658,7,99,106,42,12,9,35,41,418
54,Eric Bledsoe\bledser01,PG,29,MIL,78,78,2272,470,971,.484,124,377,.329,346,594,.582,.548,177,236,.750,82,280,362,430,116,29,165,156,1241
55,Jaron Blossomgame\blossja01,SF,25,CLE,27,4,439,47,106,.443,10,39,.256,37,67,.552,.491,10,13,.769,26,72,98,13,7,8,11,20,114
56,Bogdan Bogdanovic\bogdabo01,SG,26,SAC,70,17,1947,361,863,.418,134,372,.360,227,491,.462,.496,134,162,.827,40,203,243,267,72,15,117,142,990
57,Bojan Bogdanovic\bogdabo02,SF,29,IND,81,81,2573,522,1051,.497,164,386,.425,358,665,.538,.575,246,305,.807,33,300,333,161,69,1,134,138,1454
58,Andrew Bogut\bogutan01,C,34,GSW,11,5,134,18,36,.500,0,0,,18,36,.500,.500,3,3,1.000,12,43,55,11,3,8,8,22,39
59,Jonah Bolden\boldejo01,PF,23,PHI,44,10,639,80,162,.494,34,96,.354,46,66,.697,.599,13,27,.481,47,118,165,40,17,39,36,99,207
60,Isaac Bonga\bongais01,PG,19,LAL,22,0,120,5,33,.152,0,8,.000,5,25,.200,.152,9,15,.600,9,16,25,15,9,4,6,9,19
61,Devin Booker\bookede01,SG,22,PHO,64,64,2242,586,1255,.467,135,414,.326,451,841,.536,.521,393,454,.866,39,226,265,433,56,13,264,200,1700
62,Chris Boucher\bouchch01,PF,26,TOR,28,0,163,34,76,.447,12,37,.324,22,39,.564,.526,13,15,.867,16,40,56,2,6,24,7,31,93
63,Avery Bradley\bradlav01,SG,28,TOT,63,63,1905,248,608,.408,86,245,.351,162,363,.446,.479,43,50,.860,43,132,175,152,41,16,89,167,625
64,Tony Bradley\bradlto01,C,21,UTA,3,0,36,8,16,.500,0,0,,8,16,.500,.500,1,2,.500,9,6,15,1,2,2,3,6,17
65,Corey Brewer\breweco01,SF,32,TOT,31,3,492,53,123,.431,14,44,.318,39,79,.494,.488,31,43,.721,26,50,76,39,32,7,19,63,151
66,Mikal Bridges\bridgmi01,SF,22,PHO,82,56,2417,242,563,.430,105,313,.335,137,250,.548,.523,95,118,.805,56,208,264,173,129,38,70,201,684
67,Miles Bridges\bridgmi02,SF,20,CHO,80,25,1696,237,511,.464,65,200,.325,172,311,.553,.527,58,77,.753,67,256,323,95,55,49,50,111,597
68,Isaiah Briscoe\briscis01,PG,22,ORL,39,0,559,55,138,.399,11,34,.324,44,104,.423,.438,15,26,.577,5,69,74,87,11,2,31,66,136
69,Ryan Broekhoff\broekry01,SG,28,DAL,42,0,453,57,126,.452,38,93,.409,19,33,.576,.603,15,19,.789,8,55,63,22,6,4,16,35,167
70,Malcolm Brogdon\brogdma01,SG,26,MIL,64,64,1832,378,748,.505,104,244,.426,274,504,.544,.575,141,152,.928,65,223,288,205,46,13,91,102,1001
71,Dillon Brooks\brookdi01,SF,23,MEM,18,0,330,49,122,.402,15,40,.375,34,82,.415,.463,22,30,.733,9,22,31,16,10,4,19,50,135
72,MarShon Brooks\brookma01,SG,30,MEM,29,0,387,76,169,.450,15,54,.278,61,115,.530,.494,23,33,.697,12,33,45,25,9,4,21,33,190
73,Bruce Brown\brownbr01,SG,22,DET,74,56,1449,125,314,.398,24,93,.258,101,221,.457,.436,45,60,.750,48,137,185,91,40,36,46,178,319
74,Jaylen Brown\brownja02,SG,22,BOS,74,25,1913,368,792,.465,95,276,.344,273,516,.529,.525,133,202,.658,65,248,313,100,69,32,99,186,964
75,Lorenzo Brown\brownlo01,PG,28,TOR,26,0,212,23,71,.324,6,28,.214,17,43,.395,.366,3,3,1.000,5,26,31,28,12,5,16,22,55
76,Sterling Brown\brownst02,SG,23,MIL,58,7,1034,145,312,.465,53,147,.361,92,165,.558,.550,29,42,.690,29,155,184,84,25,8,46,88,372
77,Troy Brown\browntr01,SF,19,WAS,52,10,730,97,234,.415,22,69,.319,75,165,.455,.462,32,47,.681,35,110,145,80,21,5,30,56,248
78,Jalen Brunson\brunsja01,PG,22,DAL,73,38,1591,264,565,.467,63,181,.348,201,384,.523,.523,87,120,.725,25,144,169,230,37,4,88,127,678
79,Thomas Bryant\bryanth01,C,21,WAS,72,53,1496,309,502,.616,33,99,.333,276,403,.685,.648,107,137,.781,113,341,454,92,25,67,60,126,758
80,Reggie Bullock\bullore01,SG,27,TOT,63,60,1879,245,594,.412,148,393,.377,97,201,.483,.537,73,85,.859,22,151,173,129,40,12,65,109,711
81,Trey Burke\burketr01,PG,26,TOT,58,8,1125,236,548,.431,56,159,.352,180,389,.463,.482,103,124,.831,28,71,99,159,33,7,49,58,631
82,Alec Burks\burksal01,SG,27,TOT,64,24,1375,192,474,.405,61,168,.363,131,306,.428,.469,116,141,.823,30,205,235,128,39,21,65,91,561
83,Deonte Burton\burtode02,SG,25,OKC,32,0,240,33,82,.402,8,27,.296,25,55,.455,.451,8,12,.667,4,24,28,9,6,8,9,31,82
84,Jimmy Butler\butleji01,SF-SG,29,TOT,65,65,2185,418,904,.462,67,193,.347,351,711,.494,.499,312,365,.855,121,221,342,263,123,39,95,111,1215
85,Bruno Caboclo\cabocbr01,SF,23,MEM,34,19,800,96,225,.427,48,130,.369,48,95,.505,.533,42,50,.840,42,116,158,50,14,33,38,81,282
86,Jose Calderon\caldejo01,PG,37,DET,49,0,632,45,120,.375,14,57,.246,31,63,.492,.433,9,11,.818,11,49,60,115,16,3,35,64,113
87,Kentavious Caldwell-Pope\caldwke01,SG,25,LAL,82,23,2035,325,756,.430,151,435,.347,174,321,.542,.530,137,158,.867,48,190,238,110,73,13,65,137,938
88,Isaiah Canaan\canaais01,PG,27,TOT,30,16,629,64,164,.390,34,96,.354,30,68,.441,.494,19,24,.792,6,52,58,84,14,2,35,52,181
89,Clint Capela\capelca01,C,24,HOU,67,67,2249,474,732,.648,0,0,,474,732,.648,.648,166,261,.636,298,550,848,96,44,102,94,168,1114
90,DeMarre Carroll\carrode01,PF,32,BRK,67,8,1703,227,575,.395,106,310,.342,121,265,.457,.487,184,242,.760,68,281,349,85,31,10,73,114,744
91,Jevon Carter\carteje01,PG,23,MEM,39,3,577,56,185,.303,34,102,.333,22,83,.265,.395,26,32,.813,14,52,66,69,26,11,33,55,172
92,Vince Carter\cartevi01,SF,42,ATL,76,9,1330,196,468,.419,123,316,.389,73,152,.480,.550,47,66,.712,31,163,194,87,44,27,48,141,562
93,Wendell Carter\cartewe01,C,19,CHI,44,44,1110,180,371,.485,6,32,.188,174,339,.513,.493,89,112,.795,87,220,307,78,26,58,65,152,455
94,Michael Carter-Williams\cartemi01,PG,27,TOT,28,1,372,46,123,.374,10,38,.263,36,85,.424,.415,32,53,.604,19,51,70,70,20,15,20,48,134
95,Alex Caruso\carusal01,PG,24,LAL,25,4,531,77,173,.445,24,50,.480,53,123,.431,.514,51,64,.797,20,47,67,77,24,9,42,54,229
96,Omri Casspi\casspom01,SF,30,MEM,36,0,520,86,161,.534,15,43,.349,71,118,.602,.581,39,58,.672,17,98,115,26,20,9,23,35,226
97,Willie Cauley-Stein\caulewi01,C,25,SAC,81,81,2213,412,741,.556,1,2,.500,411,739,.556,.557,140,254,.551,181,497,678,194,96,51,84,227,965
98,Troy Caupain\caupatr01,PG,23,ORL,4,0,16,4,8,.500,2,3,.667,2,5,.400,.625,0,0,,1,2,3,4,1,0,0,0,10
99,Tyler Cavanaugh\cavanty01,PF,24,UTA,11,0,39,3,10,.300,1,5,.200,2,5,.400,.350,2,2,1.000,3,5,8,1,0,0,1,3,9
100,Tyson Chandler\chandty01,C,36,TOT,55,6,875,61,99,.616,0,1,.000,61,98,.622,.616,51,87,.586,92,215,307,37,21,23,42,110,173
101,Wilson Chandler\chandwi01,PF-SF,31,TOT,51,33,1177,114,273,.418,59,158,.373,55,115,.478,.526,18,25,.720,48,167,215,82,25,21,46,123,305
102,Joe Chealey\chealjo01,PG,23,CHO,1,0,8,1,3,.333,0,0,,1,3,.333,.333,0,0,,0,0,0,1,0,0,0,1,2
103,Chris Chiozza\chiozch01,PG,23,HOU,7,0,33,2,8,.250,2,5,.400,0,3,.000,.375,0,0,,1,3,4,4,1,1,1,2,6
104,Marquese Chriss\chrisma01,PF,21,TOT,43,2,499,67,180,.372,16,72,.222,51,108,.472,.417,32,45,.711,40,102,142,22,17,11,36,81,182
105,Gary Clark\clarkga01,PF,24,HOU,51,2,641,50,151,.331,41,138,.297,9,13,.692,.467,7,7,1.000,24,92,116,18,20,26,7,47,148
106,Ian Clark\clarkia01,SG,27,NOP,60,6,973,151,383,.394,66,202,.327,85,181,.470,.480,33,37,.892,13,76,89,94,22,8,58,95,401
107,Jordan Clarkson\clarkjo01,SG,26,CLE,81,0,2214,529,1180,.448,144,445,.324,385,735,.524,.509,162,192,.844,82,188,270,196,57,13,135,112,1364
108,John Collins\collijo01,PF,21,ATL,61,59,1829,465,831,.560,55,158,.348,410,673,.609,.593,203,266,.763,219,376,595,121,22,39,120,199,1188
109,Zach Collins\colliza01,C,21,POR,77,0,1356,189,400,.473,40,121,.331,149,279,.534,.523,94,126,.746,109,215,324,71,25,66,77,174,512
110,Darren Collison\collida01,PG,31,IND,76,76,2143,308,659,.467,79,194,.407,229,465,.492,.527,158,190,.832,36,196,232,459,110,9,125,138,853
111,Bonzie Colson\colsobo01,SF,23,MIL,8,2,98,13,39,.333,5,21,.238,8,18,.444,.397,8,9,.889,8,22,30,3,5,1,3,3,39
112,Mike Conley\conlemi01,PG,31,MEM,70,70,2342,490,1120,.438,155,426,.364,335,694,.483,.507,343,406,.845,40,199,239,449,94,22,130,123,1478
113,Pat Connaughton\connapa01,SG,26,MIL,61,2,1261,163,350,.466,66,200,.330,97,150,.647,.560,29,40,.725,61,197,258,122,33,25,33,81,421
114,Quinn Cook\cookqu01,PG,25,GSW,74,10,1059,204,439,.465,81,200,.405,123,239,.515,.557,20,26,.769,22,135,157,116,20,3,50,92,509
115,DeMarcus Cousins\couside01,C,28,GSW,30,30,771,178,371,.480,26,95,.274,152,276,.551,.515,106,144,.736,43,204,247,107,40,44,72,109,488
116,Robert Covington\covinro01,SF,28,TOT,35,35,1203,156,362,.431,85,225,.378,71,137,.518,.548,68,89,.764,28,165,193,46,74,47,47,126,465
117,Allen Crabbe\crabbal01,SG,26,BRK,43,20,1133,137,373,.367,98,259,.378,39,114,.342,.499,41,56,.732,16,132,148,46,23,13,46,102,413
118,Torrey Craig\craigto01,SF,28,DEN,75,37,1503,160,362,.442,61,188,.324,99,174,.569,.526,49,70,.700,89,174,263,72,37,46,44,175,430
119,Jamal Crawford\crawfja01,SG,38,PHO,64,0,1211,174,438,.397,67,202,.332,107,236,.453,.474,93,110,.845,8,77,85,229,33,12,99,75,508
120,Mitch Creek\creekmi01,SF,26,TOT,5,0,48,8,16,.500,0,2,.000,8,14,.571,.500,5,7,.714,6,6,12,6,2,0,1,3,21
121,Jae Crowder\crowdja01,SF,28,UTA,80,11,2166,318,797,.399,173,522,.331,145,275,.527,.508,142,197,.721,60,324,384,133,64,31,85,170,951
122,Dante Cunningham\cunnida01,PF,31,SAS,64,21,928,75,158,.475,30,65,.462,45,93,.484,.570,14,18,.778,48,140,188,50,27,13,22,71,194
123,Seth Curry\curryse01,SG,28,POR,74,2,1399,212,465,.456,113,251,.450,99,214,.463,.577,44,52,.846,27,93,120,66,36,12,61,97,581
124,Stephen Curry\curryst01,PG,30,GSW,69,69,2331,632,1340,.472,354,810,.437,278,530,.525,.604,263,287,.916,45,324,369,361,92,25,192,166,1881
125,Troy Daniels\danietr01,SG,27,PHO,51,1,760,113,275,.411,74,194,.381,39,81,.481,.545,18,23,.783,13,60,73,26,26,5,27,79,318
126,Anthony Davis\davisan02,C,25,NOP,56,56,1850,530,1026,.517,48,145,.331,482,881,.547,.540,344,433,.794,174,498,672,218,88,135,112,132,1452
127,Deyonta Davis\davisde01,C,22,ATL,9,0,118,15,22,.682,0,1,.000,15,21,.714,.682,6,10,.600,10,26,36,5,3,5,3,12,36
128,Ed Davis\davised01,C,29,BRK,81,1,1446,186,302,.616,0,2,.000,186,300,.620,.616,100,162,.617,216,478,694,61,35,33,64,226,472
129,Tyler Davis\davisty01,C,21,OKC,1,0,1,0,1,.000,0,0,,0,1,.000,.000,0,0,,1,0,1,0,0,0,0,0,0
130,Dewayne Dedmon\dedmode01,C,29,ATL,64,52,1609,259,526,.492,83,217,.382,176,309,.570,.571,92,113,.814,105,375,480,90,69,71,84,214,693
131,Sam Dekker\dekkesa01,PF,24,TOT,47,5,788,120,256,.469,19,62,.306,101,194,.521,.506,28,46,.609,53,95,148,46,38,7,24,47,287
132,Angel Delgado\delgaan01,C,24,LAC,2,0,15,1,5,.200,0,0,,1,5,.200,.200,1,2,.500,2,2,4,0,1,0,0,2,3
133,Matthew Dellavedova\dellama01,PG,28,TOT,48,0,812,98,242,.405,44,130,.338,54,112,.482,.496,42,52,.808,6,71,77,181,14,2,68,75,282
134,Luol Deng\denglu01,SF,33,MIN,22,2,392,59,118,.500,14,44,.318,45,74,.608,.559,25,35,.714,20,53,73,18,15,8,14,24,157
135,DeMar DeRozan\derozde01,SG,29,SAS,77,77,2688,631,1313,.481,7,45,.156,624,1268,.492,.483,366,441,.830,54,408,462,475,86,36,199,177,1635
136,Marcus Derrickson\derrima01,PF,22,GSW,11,0,67,16,33,.485,10,20,.500,6,13,.462,.636,4,5,.800,8,5,13,1,0,1,3,9,46
137,Cheick Diallo\diallch01,PF,22,NOP,64,1,896,168,271,.620,1,4,.250,167,267,.625,.622,50,67,.746,75,257,332,33,29,33,49,113,387
138,Hamidou Diallo\diallha01,SG,20,OKC,51,3,526,75,165,.455,4,24,.167,71,141,.504,.467,36,59,.610,38,59,97,17,21,10,23,77,190
139,Gorgui Dieng\dienggo01,C,29,MIN,76,2,1031,189,377,.501,19,56,.339,170,321,.530,.527,88,106,.830,81,230,311,72,48,41,57,134,485
140,Spencer Dinwiddie\dinwisp01,PG,25,BRK,68,4,1914,366,828,.442,124,370,.335,242,458,.528,.517,287,356,.806,26,140,166,311,40,17,152,187,1143
141,Donte DiVincenzo\divindo01,SG,22,MIL,27,0,411,50,124,.403,22,83,.265,28,41,.683,.492,9,12,.750,16,49,65,31,13,6,19,38,131
142,Luka Doncic\doncilu01,SG,19,DAL,72,72,2318,506,1186,.427,168,514,.327,338,672,.503,.497,346,485,.713,86,477,563,429,77,25,247,137,1526
143,Tyler Dorsey\dorsety01,SG,22,TOT,48,11,698,107,264,.405,44,132,.333,63,132,.477,.489,38,61,.623,27,86,113,56,14,2,27,53,296
144,Damyean Dotson\dotsoda01,SG,24,NYK,73,40,2004,290,698,.415,126,342,.368,164,356,.461,.506,73,98,.745,34,228,262,135,58,10,71,135,779
145,PJ Dozier\doziepj01,SG,22,BOS,6,0,51,8,21,.381,2,8,.250,6,13,.462,.429,1,2,.500,6,11,17,5,2,0,0,2,19
146,Goran Dragic\dragigo01,PG,32,MIA,36,22,991,179,433,.413,57,164,.348,122,269,.454,.479,79,101,.782,20,91,111,174,30,5,71,81,494
147,Andre Drummond\drumman01,C,25,DET,79,79,2647,561,1052,.533,5,38,.132,556,1014,.548,.536,243,412,.590,423,809,1232,112,136,138,175,272,1370
148,Jared Dudley\dudleja01,PF,33,BRK,59,25,1220,101,239,.423,53,151,.351,48,88,.545,.533,32,46,.696,34,121,155,83,36,16,43,131,287
149,Kris Dunn\dunnkr01,PG,24,CHI,46,44,1389,215,506,.425,34,96,.354,181,410,.441,.458,55,69,.797,19,168,187,277,68,21,104,166,519
150,Kevin Durant\duranke01,PF,30,GSW,78,78,2702,721,1383,.521,137,388,.353,584,995,.587,.571,448,506,.885,33,464,497,457,58,84,225,155,2027
151,Trevon Duval\duvaltr01,PG,20,MIL,3,0,6,2,3,.667,1,1,1.000,1,2,.500,.833,0,0,,0,1,1,2,0,0,0,0,5
152,Vince Edwards\edwarvi01,SF,22,HOU,2,0,16,1,4,.250,1,4,.250,0,0,,.375,0,0,,1,1,2,0,0,0,0,0,3
153,Henry Ellenson\ellenhe01,PF,22,TOT,19,0,259,39,95,.411,17,38,.447,22,57,.386,.500,19,25,.760,5,61,66,16,7,2,9,27,114
154,Wayne Ellington\ellinwa01,SG,31,TOT,53,38,1297,184,457,.403,138,372,.371,46,85,.541,.554,39,49,.796,14,93,107,72,54,6,40,92,545
155,Joel Embiid\embiijo01,C,24,PHI,64,64,2154,580,1199,.484,79,263,.300,501,936,.535,.517,522,649,.804,160,711,871,234,46,122,226,211,1761
156,James Ennis\ennisja01,SF,28,TOT,58,27,1230,138,294,.469,55,156,.353,83,138,.601,.563,58,81,.716,60,122,182,41,41,23,34,150,389
157,Drew Eubanks\eubandr01,PF,21,SAS,23,0,113,15,26,.577,0,0,,15,26,.577,.577,11,13,.846,6,28,34,7,2,5,8,11,41
158,Jacob Evans\evansja02,SG,21,GSW,30,1,204,18,53,.340,4,15,.267,14,38,.368,.377,0,1,.000,6,19,25,23,5,3,11,28,40
159,Jawun Evans\evansja01,PG,22,TOT,8,0,65,3,14,.214,0,3,.000,3,11,.273,.214,0,0,,1,11,12,10,3,0,6,8,6
160,Tyreke Evans\evansty01,SG,29,IND,69,18,1402,257,660,.389,77,216,.356,180,444,.405,.448,115,160,.719,33,168,201,166,58,18,118,118,706
161,Dante Exum\exumda01,PG,23,UTA,42,1,664,101,241,.419,18,62,.290,83,179,.464,.456,68,86,.791,16,52,68,110,14,5,52,69,288
162,Kenneth Faried\farieke01,C,29,TOT,37,13,728,156,265,.589,8,25,.320,148,240,.617,.604,64,99,.646,97,153,250,20,17,23,33,82,384
163,Derrick Favors\favorde01,C,27,UTA,76,70,1766,363,619,.586,17,78,.218,346,541,.640,.600,154,228,.675,207,353,560,89,56,106,84,163,897
164,Cristiano Felicio\feliccr01,C,26,CHI,60,0,746,95,179,.531,0,4,.000,95,175,.543,.531,50,73,.685,79,139,218,37,11,7,33,69,240
165,Raymond Felton\feltora01,PG,34,OKC,33,0,379,55,135,.407,20,61,.328,35,74,.473,.481,12,13,.923,4,30,34,52,10,6,14,29,142
166,Terrance Ferguson\fergute01,SG,20,OKC,74,74,1931,185,431,.429,106,290,.366,79,141,.560,.552,37,51,.725,33,108,141,72,40,16,47,231,513
167,Yogi Ferrell\ferreyo01,PG,25,SAC,71,3,1067,153,352,.435,54,149,.362,99,203,.488,.511,60,67,.896,13,96,109,137,36,4,40,64,420
168,Dorian Finney-Smith\finnedo01,SF,25,DAL,81,26,1985,228,528,.432,79,254,.311,149,274,.544,.507,73,103,.709,138,251,389,95,69,36,74,186,608
169,Bryn Forbes\forbebr01,SG,25,SAS,82,81,2293,361,791,.456,176,413,.426,185,378,.489,.568,69,78,.885,18,221,239,175,45,4,80,159,967
170,Evan Fournier\fournev01,SG,26,ORL,81,81,2553,468,1069,.438,153,450,.340,315,619,.509,.509,137,170,.806,38,220,258,295,71,12,154,225,1226
171,De'Aaron Fox\foxde01,PG,21,SAC,81,81,2546,505,1102,.458,86,232,.371,419,870,.482,.497,303,417,.727,43,261,304,590,133,45,227,204,1399
172,Melvin Frazier\frazime01,SG,22,ORL,10,0,44,7,21,.333,0,6,.000,7,15,.467,.333,1,4,.250,3,2,5,1,1,0,1,6,15
173,Tim Frazier\fraziti01,PG,28,TOT,59,19,1120,116,261,.444,37,101,.366,79,160,.494,.515,41,54,.759,41,127,168,248,30,5,76,112,310
174,Jimmer Fredette\fredeji01,SG,29,PHO,6,0,65,8,29,.276,0,13,.000,8,16,.500,.276,6,6,1.000,1,6,7,8,3,0,5,5,22
175,Channing Frye\fryech01,C,35,CLE,36,6,341,43,117,.368,32,79,.405,11,38,.289,.504,11,14,.786,4,48,52,20,6,5,13,44,129
176,Markelle Fultz\fultzma01,SG,20,PHI,19,15,427,65,155,.419,4,14,.286,61,141,.433,.432,21,37,.568,26,44,70,59,17,5,25,52,155
177,Danilo Gallinari\gallida01,SF,30,LAC,68,68,2059,409,884,.463,161,372,.433,248,512,.484,.554,367,406,.904,54,363,417,178,49,23,99,129,1346
178,Langston Galloway\gallola01,SG,27,DET,80,4,1745,228,587,.388,135,380,.355,93,207,.449,.503,81,96,.844,49,122,171,85,37,8,24,135,672
179,Billy Garrett\garrebi01,SG,24,NYK,4,0,63,11,27,.407,0,8,.000,11,19,.579,.407,4,4,1.000,0,3,3,7,1,1,2,3,26
180,Marc Gasol\gasolma01,C,34,TOT,79,72,2436,390,870,.448,99,273,.363,291,597,.487,.505,192,253,.759,80,547,627,349,84,86,155,217,1071
181,Pau Gasol\gasolpa01,C,38,TOT,30,6,360,42,94,.447,6,13,.462,36,81,.444,.479,28,40,.700,22,115,137,52,5,15,16,29,118
182,Rudy Gay\gayru01,PF,32,SAS,69,51,1842,376,746,.504,74,184,.402,302,562,.537,.554,120,147,.816,63,407,470,182,54,34,114,159,946
183,Paul George\georgpa01,SF,28,OKC,77,77,2841,707,1614,.438,292,757,.386,415,857,.484,.529,453,540,.839,105,523,628,318,170,34,205,214,2159
184,Taj Gibson\gibsota01,PF,33,MIN,70,57,1686,304,537,.566,11,34,.324,293,503,.583,.576,134,177,.757,172,286,458,84,53,39,73,186,753
185,Harry Giles\gilesha01,PF,20,SAC,58,0,820,175,348,.503,0,6,.000,175,342,.512,.503,58,91,.637,66,156,222,85,31,22,73,150,408
186,Shai Gilgeous-Alexander\gilgesh01,PG,20,LAC,82,73,2174,341,716,.476,51,139,.367,290,577,.503,.512,156,195,.800,57,175,232,270,96,45,141,175,889
187,Rudy Gobert\goberru01,C,26,UTA,81,80,2577,476,712,.669,0,0,,476,712,.669,.669,332,522,.636,309,732,1041,161,66,187,130,231,1284
188,Brandon Goodwin\goodwbr01,PG,23,DEN,16,0,57,6,23,.261,2,6,.333,4,17,.235,.304,9,11,.818,1,2,3,14,0,0,3,7,23
189,Aaron Gordon\gordoaa01,PF,23,ORL,78,78,2633,470,1046,.449,121,347,.349,349,699,.499,.507,185,253,.731,129,445,574,289,57,56,162,172,1246
190,Eric Gordon\gordoer01,SG,30,HOU,68,53,2158,384,938,.409,216,600,.360,168,338,.497,.525,119,152,.783,17,131,148,129,41,27,90,143,1103
191,Marcin Gortat\gortama01,C,34,LAC,47,43,751,99,186,.532,0,0,,99,186,.532,.532,35,48,.729,67,194,261,65,6,24,50,92,233
192,Devonte' Graham\grahade01,PG,23,CHO,46,3,676,74,216,.343,34,121,.281,40,95,.421,.421,35,46,.761,10,53,63,121,23,2,30,48,217
193,Treveon Graham\grahatr01,SG,25,BRK,35,21,715,64,191,.335,38,128,.297,26,63,.413,.435,18,22,.818,23,84,107,34,13,7,17,68,184
194,Jerami Grant\grantje01,PF,24,OKC,80,77,2612,409,823,.497,115,293,.392,294,530,.555,.567,157,221,.710,96,321,417,79,61,100,67,214,1090
195,Jerian Grant\grantje02,PG,26,ORL,60,1,939,92,220,.418,40,110,.364,52,110,.473,.509,26,40,.650,19,79,98,156,44,6,51,78,250
196,Donte Grantham\grantdo01,SF,23,OKC,3,0,2,0,2,.000,0,2,.000,0,0,,.000,0,0,,0,0,0,0,0,0,0,0,0
197,Danny Green\greenda02,SG,31,TOR,80,80,2216,293,630,.465,198,435,.455,95,195,.487,.622,37,44,.841,60,257,317,126,73,53,75,171,821
198,Draymond Green\greendr01,PF,28,GSW,66,66,2065,188,422,.445,47,165,.285,141,257,.549,.501,63,91,.692,60,421,481,454,95,70,169,197,486
199,Gerald Green\greenge01,SG,33,HOU,73,0,1473,231,578,.400,156,441,.354,75,137,.547,.535,57,68,.838,30,152,182,40,33,27,55,126,675
200,JaMychal Green\greenja01,PF,28,TOT,65,6,1371,230,476,.483,71,176,.403,159,300,.530,.558,80,101,.792,104,305,409,50,45,34,87,193,611
201,Jeff Green\greenje02,PF,32,WAS,77,44,2097,326,687,.475,111,320,.347,215,367,.586,.555,183,206,.888,57,252,309,137,43,39,101,160,946
202,Blake Griffin\griffbl01,PF,29,DET,75,75,2622,619,1341,.462,189,522,.362,430,819,.525,.532,414,550,.753,100,465,565,402,52,28,253,199,1841
203,Daniel Hamilton\hamilda02,SG,23,ATL,19,3,204,23,60,.383,8,23,.348,15,37,.405,.450,3,6,.500,10,37,47,22,6,1,16,19,57
204,Dusty Hannahs\hannadu01,SG,25,MEM,2,0,26,3,12,.250,0,5,.000,3,7,.429,.250,2,2,1.000,0,1,1,5,1,0,1,1,8
205,Tim Hardaway\hardati02,SG,26,TOT,65,63,2057,390,993,.393,162,477,.340,228,516,.442,.474,232,276,.841,33,189,222,159,54,8,105,141,1174
206,James Harden\hardeja01,PG,29,HOU,78,78,2867,843,1909,.442,378,1028,.368,465,881,.528,.541,754,858,.879,66,452,518,586,158,58,387,244,2818
207,Maurice Harkless\harklma01,SF,25,POR,60,53,1415,189,388,.487,33,120,.275,156,268,.582,.530,49,73,.671,77,192,269,74,67,53,45,163,460
208,Montrezl Harrell\harremo01,C,25,LAC,82,5,2158,546,888,.615,3,17,.176,543,871,.623,.617,266,414,.643,184,351,535,162,71,110,132,255,1361
209,Devin Harris\harride01,PG,35,DAL,68,2,1071,132,347,.380,62,200,.310,70,147,.476,.470,102,134,.761,12,100,112,122,35,16,56,133,428
210,Gary Harris\harriga01,SG,24,DEN,57,48,1639,270,637,.424,82,242,.339,188,395,.476,.488,115,144,.799,41,119,160,127,55,19,68,113,737
211,Joe Harris\harrijo01,SG,27,BRK,76,76,2293,374,748,.500,183,386,.474,191,362,.528,.622,110,133,.827,52,239,291,181,38,17,121,182,1041
212,Tobias Harris\harrito02,PF,26,TOT,82,82,2847,611,1254,.487,156,393,.397,455,861,.528,.549,266,307,.866,69,576,645,229,51,37,151,184,1644
213,Andrew Harrison\harrian01,PG,24,TOT,17,0,187,16,53,.302,5,25,.200,11,28,.393,.349,17,18,.944,6,14,20,24,4,2,12,34,54
214,Shaquille Harrison\harrish01,PG,25,CHI,73,11,1430,184,426,.432,24,89,.270,160,337,.475,.460,82,123,.667,33,189,222,139,89,30,60,124,474
215,Josh Hart\hartjo01,SG,23,LAL,67,22,1715,189,464,.407,92,274,.336,97,190,.511,.506,55,80,.688,35,213,248,93,64,40,58,147,525
216,Isaiah Hartenstein\harteis01,PF,20,HOU,28,0,221,20,41,.488,2,6,.333,18,35,.514,.512,11,14,.786,21,26,47,15,7,12,13,56,53
217,Udonis Haslem\hasleud01,C,38,MIA,10,1,74,11,33,.333,0,12,.000,11,21,.524,.333,3,4,.750,3,24,27,2,0,0,3,9,25
218,Gordon Hayward\haywago01,PF,28,BOS,72,18,1863,296,635,.466,77,231,.333,219,404,.542,.527,156,187,.834,51,271,322,244,62,23,105,104,825
219,John Henson\hensojo01,C,28,MIL,14,0,188,31,67,.463,11,31,.355,20,36,.556,.545,6,10,.600,16,55,71,14,7,11,12,16,79
220,Juan Hernangomez\hernaju01,PF,23,DEN,70,25,1358,138,314,.439,66,181,.365,72,133,.541,.545,66,86,.767,64,201,265,55,27,24,37,94,408
221,Willy Hernangomez\hernawi01,C,24,CHO,58,3,812,153,295,.519,15,39,.385,138,256,.539,.544,100,144,.694,117,194,311,60,16,20,58,98,421
222,Mario Hezonja\hezonma01,SF,23,NYK,58,24,1206,191,464,.412,42,152,.276,149,312,.478,.457,87,114,.763,28,211,239,88,57,8,88,110,511
223,Isaiah Hicks\hicksis01,PF,24,NYK,3,0,32,4,8,.500,0,0,,4,8,.500,.500,4,5,.800,2,5,7,2,1,3,1,5,12
224,Buddy Hield\hieldbu01,SG,26,SAC,82,82,2615,623,1360,.458,278,651,.427,345,709,.487,.560,171,193,.886,106,306,412,205,58,33,146,202,1695
225,Haywood Highsmith\highsha01,SF,22,PHI,5,0,40,4,10,.400,1,5,.200,3,5,.600,.450,0,2,.000,0,5,5,2,1,0,1,1,9
226,Nene Hilario\hilarne01,C,36,HOU,42,2,546,60,116,.517,0,3,.000,60,113,.531,.517,31,47,.660,34,89,123,26,18,15,11,87,151
227,George Hill\hillge01,PG,32,TOT,60,13,1302,170,376,.452,48,153,.314,122,223,.547,.516,70,85,.824,39,109,148,135,52,8,51,102,458
228,Solomon Hill\hillso01,SF,27,NOP,44,15,878,68,178,.382,32,101,.317,36,77,.468,.472,23,32,.719,34,99,133,55,23,10,31,80,191
229,Aaron Holiday\holidaa01,PG,22,IND,50,0,646,105,262,.401,43,127,.339,62,135,.459,.483,41,50,.820,5,62,67,87,21,13,40,70,294
230,Jrue Holiday\holidjr01,SG,28,NOP,67,67,2402,547,1159,.472,118,363,.325,429,796,.539,.523,208,271,.768,75,259,334,518,109,54,210,148,1420
231,Justin Holiday\holidju01,SG,29,TOT,82,77,2607,300,777,.386,162,465,.348,138,312,.442,.490,95,106,.896,46,277,323,146,121,36,104,164,857
232,John Holland\hollajo02,SF,30,CLE,1,0,1,0,0,,0,0,,0,0,,,0,0,,0,0,0,0,0,0,0,0,0
233,Rondae Hollis-Jefferson\holliro01,SF,24,BRK,59,21,1234,200,487,.411,9,49,.184,191,438,.436,.420,118,183,.645,83,227,310,96,44,27,68,107,527
234,Richaun Holmes\holmeri01,C,25,PHO,70,4,1184,222,365,.608,0,0,,222,365,.608,.608,128,175,.731,115,216,331,60,42,79,52,194,572
235,Rodney Hood\hoodro01,SG,26,TOT,72,49,1893,292,671,.435,84,236,.356,208,435,.478,.498,137,155,.884,25,132,157,126,59,12,55,146,805
236,Al Horford\horfoal01,C,32,BOS,68,68,1973,387,723,.535,73,203,.360,314,520,.604,.586,78,95,.821,120,338,458,283,59,86,102,126,925
237,Danuel House\houseda01,SF,25,HOU,39,13,979,118,252,.468,74,178,.416,44,74,.595,.615,56,71,.789,25,115,140,40,21,11,35,80,366
238,Dwight Howard\howardw01,C,33,WAS,9,9,230,43,69,.623,0,0,,43,69,.623,.623,29,48,.604,24,59,83,4,7,4,16,34,115
239,Kevin Huerter\huertke01,SG,20,ATL,75,59,2048,275,657,.419,136,353,.385,139,304,.457,.522,41,56,.732,60,185,245,214,65,25,109,155,727
240,Isaac Humphries\humphis01,C,21,ATL,5,1,56,6,21,.286,3,11,.273,3,10,.300,.357,0,0,,4,7,11,0,1,0,0,7,15
241,R.J. Hunter\hunterj01,SG,25,BOS,1,0,26,6,13,.462,4,10,.400,2,3,.667,.615,1,2,.500,1,2,3,3,1,0,0,3,17
242,Chandler Hutchison\hutchch01,SF,22,CHI,44,14,895,96,209,.459,14,50,.280,82,159,.516,.493,23,38,.605,31,154,185,34,23,6,25,59,229
243,Serge Ibaka\ibakase01,C,29,TOR,74,51,2010,464,877,.529,49,169,.290,415,708,.586,.557,135,177,.763,156,445,601,99,29,103,114,211,1112
244,Andre Iguodala\iguodan01,SF,35,GSW,68,13,1578,151,302,.500,48,144,.333,103,158,.652,.579,39,67,.582,48,204,252,216,61,51,52,95,389
245,Ersan Ilyasova\ilyaser01,PF,31,MIL,67,7,1231,167,381,.438,58,160,.363,109,221,.493,.514,61,74,.824,94,208,302,52,32,20,48,172,453
246,Joe Ingles\inglejo01,PF,31,UTA,82,82,2568,359,802,.448,189,483,.391,170,319,.533,.565,87,123,.707,35,295,330,469,98,20,193,180,994
247,Andre Ingram\ingraan01,SG,33,LAL,4,0,15,0,6,.000,0,3,.000,0,3,.000,.000,0,0,,1,1,2,0,1,0,1,0,0
248,Brandon Ingram\ingrabr01,SF,21,LAL,52,52,1760,362,729,.497,31,94,.330,331,635,.521,.518,195,289,.675,41,226,267,154,28,31,129,149,950
249,Kyrie Irving\irvinky01,PG,26,BOS,67,67,2214,604,1241,.487,174,434,.401,430,807,.533,.557,214,245,.873,71,264,335,464,103,34,172,167,1596
250,Jonathan Isaac\isaacjo01,PF,21,ORL,75,64,1996,262,611,.429,86,266,.323,176,345,.510,.499,110,135,.815,99,312,411,80,59,98,75,143,720
251,Wesley Iwundu\iwundwe01,SF,24,ORL,68,13,1233,113,274,.412,29,79,.367,84,195,.431,.465,84,103,.816,37,147,184,73,28,22,44,123,339
252,Demetrius Jackson\jacksde01,PG,24,PHI,6,0,39,8,15,.533,2,6,.333,6,9,.667,.600,4,4,1.000,2,1,3,5,2,0,1,4,22
253,Frank Jackson\jacksfr01,PG,20,NOP,61,16,1169,194,447,.434,53,169,.314,141,278,.507,.493,54,73,.740,25,109,134,69,25,2,48,92,495
254,Jaren Jackson\jacksja02,PF,19,MEM,58,56,1515,298,589,.506,51,142,.359,247,447,.553,.549,151,197,.766,73,199,272,64,52,82,98,220,798
255,Josh Jackson\jacksjo02,SG,21,PHO,79,29,1988,347,841,.413,73,225,.324,274,616,.445,.456,143,213,.671,66,281,347,183,74,56,173,209,910
256,Justin Jackson\jacksju01,SF,23,TOT,81,14,1614,217,485,.447,87,245,.355,130,240,.542,.537,62,79,.785,44,168,212,96,32,14,29,99,583
257,Reggie Jackson\jacksre01,PG,28,DET,82,82,2289,441,1047,.421,174,471,.369,267,576,.464,.504,204,236,.864,45,171,216,344,55,9,148,208,1260
258,LeBron James\jamesle01,SF,34,LAL,55,55,1937,558,1095,.510,111,327,.339,447,768,.582,.560,278,418,.665,57,408,465,454,72,33,197,94,1505
259,Amile Jefferson\jeffeam01,PF,25,ORL,12,0,68,10,16,.625,0,0,,10,16,.625,.625,7,8,.875,6,15,21,3,3,3,1,8,27
260,John Jenkins\jenkijo01,SG,27,TOT,26,0,333,42,105,.400,22,58,.379,20,47,.426,.505,15,18,.833,6,31,37,22,0,2,9,10,121
261,Jonas Jerebko\jerebjo01,PF,31,GSW,73,6,1218,163,355,.459,69,188,.367,94,167,.563,.556,64,80,.800,72,216,288,96,27,18,43,137,459
262,Alize Johnson\johnsal02,PF,22,IND,14,0,64,4,16,.250,1,2,.500,3,14,.214,.281,4,8,.500,4,15,19,1,1,3,0,7,13
263,Amir Johnson\johnsam01,C,31,PHI,51,6,529,79,157,.503,12,40,.300,67,117,.573,.541,31,41,.756,47,100,147,60,16,13,45,99,201
264,B.J. Johnson\johnsbj01,SF,23,TOT,7,0,49,9,18,.500,3,7,.429,6,11,.545,.583,2,2,1.000,2,6,8,0,2,0,2,4,23
265,James Johnson\johnsja01,PF,31,MIA,55,33,1164,164,379,.433,50,149,.336,114,230,.496,.499,50,70,.714,22,154,176,135,35,27,74,114,428
266,Stanley Johnson\johnsst04,SF,22,TOT,66,7,1208,171,440,.389,62,215,.288,109,225,.484,.459,50,64,.781,34,183,217,88,60,14,81,114,454
267,Tyler Johnson\johnsty01,PG,26,TOT,57,22,1529,217,526,.413,90,260,.346,127,266,.477,.498,95,127,.748,34,139,173,166,54,27,77,97,619
268,Wesley Johnson\johnswe01,SF,31,TOT,38,13,534,45,128,.352,25,76,.329,20,52,.385,.449,13,19,.684,12,60,72,23,14,12,18,63,128
269,Nikola Jokic\jokicni01,C,23,DEN,80,80,2504,616,1206,.511,83,270,.307,533,936,.569,.545,289,352,.821,228,637,865,580,108,55,248,228,1604
270,Damian Jones\jonesda03,C,23,GSW,24,22,410,53,74,.716,0,0,,53,74,.716,.716,24,37,.649,31,44,75,28,12,25,16,63,130
271,Derrick Jones\jonesde02,SF,21,MIA,60,14,1153,160,324,.494,28,91,.308,132,233,.567,.537,74,122,.607,96,144,240,37,46,42,43,123,422
272,Jalen Jones\jonesja04,SF,25,CLE,16,0,214,26,62,.419,10,28,.357,16,34,.471,.500,19,27,.704,11,23,34,7,9,2,8,27,81
273,Jemerrio Jones\jonesje01,SF,23,LAL,6,2,143,12,33,.364,2,10,.200,10,23,.435,.394,1,2,.500,16,33,49,13,7,5,5,10,27
274,Terrence Jones\joneste01,PF,27,HOU,2,0,5,1,4,.250,0,2,.000,1,2,.500,.250,0,1,.000,0,4,4,0,0,0,1,1,2
275,Tyus Jones\jonesty01,PG,22,MIN,68,23,1560,185,446,.415,40,126,.317,145,320,.453,.460,58,69,.841,23,111,134,327,81,5,47,78,468
276,DeAndre Jordan\jordade01,C,30,TOT,69,69,2047,286,446,.641,0,0,,286,446,.641,.641,186,264,.705,225,677,902,156,42,73,153,167,758
277,Cory Joseph\josepco01,PG,27,IND,82,9,2063,226,548,.412,55,171,.322,171,377,.454,.463,30,43,.698,39,240,279,321,94,22,80,131,537
278,Frank Kaminsky\kaminfr01,C,25,CHO,47,0,755,138,298,.463,50,139,.360,88,159,.553,.547,79,107,.738,39,124,163,63,12,12,41,68,405
279,Enes Kanter\kanteen01,C,26,TOT,67,31,1640,375,683,.549,10,34,.294,365,649,.562,.556,155,197,.787,257,402,659,116,32,26,118,167,915
280,Luke Kennard\kennalu01,SG,22,DET,63,10,1437,228,520,.438,106,269,.394,122,251,.486,.540,51,61,.836,12,171,183,114,26,10,57,92,613
281,Michael Kidd-Gilchrist\kiddgmi01,PF,25,CHO,64,3,1179,158,332,.476,16,47,.340,142,285,.498,.500,95,123,.772,88,158,246,61,32,39,43,156,427
282,George King\kingge03,SF,25,PHO,1,0,6,0,0,,0,0,,0,0,,,0,0,,0,1,1,0,0,0,0,0,0
283,Maxi Kleber\klebima01,PF,27,DAL,71,18,1502,175,386,.453,77,218,.353,98,168,.583,.553,58,74,.784,90,239,329,70,36,78,54,143,485
284,Brandon Knight\knighbr03,PG,27,TOT,39,26,736,99,260,.381,41,129,.318,58,131,.443,.460,27,34,.794,10,49,59,71,21,2,30,62,266
285,Kevin Knox\knoxke01,PF,19,NYK,75,57,2158,338,914,.370,125,364,.343,213,550,.387,.438,162,226,.717,61,274,335,82,43,24,114,175,963
286,Furkan Korkmaz\korkmfu01,SG,21,PHI,48,7,679,98,245,.400,47,144,.326,51,101,.505,.496,36,44,.818,16,91,107,52,29,2,25,62,279
287,Luke Kornet\kornelu01,PF,23,NYK,46,18,784,107,283,.378,70,193,.363,37,90,.411,.502,38,46,.826,28,107,135,54,27,42,25,41,322
288,Kyle Korver\korveky01,SG-PF,37,TOT,70,0,1334,201,483,.416,138,348,.397,63,135,.467,.559,60,73,.822,9,153,162,81,25,12,59,106,600
289,Kosta Koufos\koufoko01,C,29,SAC,42,1,502,73,153,.477,0,0,,73,153,.477,.477,10,24,.417,52,125,177,36,15,18,27,68,156
290,Rodions Kurucs\kurucro01,SF,20,BRK,63,46,1294,202,449,.450,58,184,.315,144,265,.543,.514,72,92,.783,56,190,246,52,41,25,77,146,534
291,Kyle Kuzma\kuzmaky01,PF,23,LAL,70,68,2314,496,1087,.456,128,422,.303,368,665,.553,.515,188,250,.752,60,322,382,178,41,26,133,170,1308
292,Skal Labissiere\labissk01,PF,22,TOT,22,1,176,26,49,.531,6,13,.462,20,36,.556,.592,9,17,.529,9,34,43,11,5,6,11,29,67
293,Jeremy Lamb\lambje01,SG,26,CHO,79,55,2250,431,979,.440,115,330,.348,316,649,.487,.499,231,260,.888,65,369,434,172,88,32,80,140,1208
294,Zach LaVine\lavinza01,SG,23,CHI,63,62,2171,530,1135,.467,120,321,.374,410,814,.504,.520,312,375,.832,40,254,294,283,60,26,215,140,1492
295,Jake Layman\laymaja01,SF,24,POR,71,33,1327,216,424,.509,59,181,.326,157,243,.646,.579,50,71,.704,56,161,217,53,31,30,46,116,541
296,T.J. Leaf\leaftj01,PF,21,IND,58,1,522,99,183,.541,8,31,.258,91,152,.599,.563,19,31,.613,43,82,125,24,9,19,12,35,225
297,Courtney Lee\leeco01,SG,33,TOT,34,6,428,53,129,.411,16,55,.291,37,74,.500,.473,14,21,.667,9,45,54,37,21,3,14,32,136
298,Damion Lee\leeda03,SG,26,GSW,32,0,375,56,127,.441,27,68,.397,29,59,.492,.547,19,22,.864,8,56,64,13,13,0,11,28,158
299,Walt Lemon\lemonwa01,PG,26,CHI,6,3,167,38,87,.437,2,5,.400,36,82,.439,.448,8,11,.727,4,23,27,30,11,1,10,14,86
300,Alex Len\lenal01,C,25,ATL,77,31,1544,320,648,.494,74,204,.363,246,444,.554,.551,140,216,.648,158,266,424,86,27,69,97,200,854
301,Kawhi Leonard\leonaka01,SF,27,TOR,60,60,2040,560,1129,.496,112,302,.371,448,827,.542,.546,364,426,.854,78,361,439,199,106,24,121,87,1596
302,Meyers Leonard\leoname01,C,26,POR,61,2,878,132,242,.545,50,111,.450,82,131,.626,.649,43,51,.843,49,184,233,75,13,9,43,105,357
303,Jon Leuer\leuerjo01,PF,29,DET,41,1,402,66,113,.584,1,11,.091,65,102,.637,.588,23,31,.742,27,70,97,14,12,4,23,60,156
304,Caris LeVert\leverca01,SF,24,BRK,40,25,1063,207,483,.429,48,154,.312,159,329,.483,.478,85,123,.691,35,116,151,156,42,14,69,77,547
305,Damian Lillard\lillada01,PG,28,POR,80,80,2838,681,1533,.444,237,643,.369,444,890,.499,.522,468,513,.912,68,303,371,551,88,34,212,148,2067
306,Jeremy Lin\linje01,PG,30,TOT,74,4,1436,238,541,.440,55,187,.294,183,354,.517,.491,176,210,.838,22,157,179,231,47,13,124,144,707
307,Shaun Livingston\livinsh01,PG,33,GSW,64,0,967,109,210,.519,0,2,.000,109,208,.524,.519,40,51,.784,42,75,117,114,31,27,38,74,258
308,Zach Lofton\loftoza01,SG,26,DET,1,0,4,0,1,.000,0,1,.000,0,0,,.000,0,0,,0,0,0,0,1,0,1,0,0
309,Kevon Looney\looneke01,C,22,GSW,80,24,1481,217,347,.625,1,10,.100,216,337,.641,.627,65,105,.619,194,223,417,123,46,53,51,211,500
310,Brook Lopez\lopezbr01,C,30,MIL,81,81,2322,355,786,.452,187,512,.365,168,274,.613,.571,112,133,.842,33,363,396,98,51,179,82,189,1009
311,Robin Lopez\lopezro01,C,30,CHI,74,36,1606,304,535,.568,7,31,.226,297,504,.589,.575,89,123,.724,140,146,286,89,11,78,96,124,704
312,Kevin Love\loveke01,PF,30,CLE,22,21,598,109,283,.385,53,147,.361,56,136,.412,.479,103,114,.904,33,206,239,48,6,5,42,54,374
313,Kyle Lowry\lowryky01,PG,32,TOR,65,65,2213,304,739,.411,157,453,.347,147,286,.514,.518,161,194,.830,41,271,312,564,91,31,182,166,926
314,Jordan Loyd\loydjo01,PG,25,TOR,12,0,55,8,18,.444,4,8,.500,4,10,.400,.556,9,11,.818,1,8,9,6,0,0,2,5,29
315,Kalin Lucas\lucaska01,PG,29,DET,1,0,6,0,1,.000,0,1,.000,0,0,,.000,2,2,1.000,0,3,3,1,0,0,0,1,2
316,Timothe Luwawu-Cabarrot\luwawti01,SF,23,TOT,50,7,669,82,218,.376,36,116,.310,46,102,.451,.459,31,41,.756,11,86,97,26,19,8,21,73,231
317,Tyler Lydon\lydonty01,PF,22,DEN,25,0,94,9,18,.500,4,10,.400,5,8,.625,.611,1,3,.333,7,11,18,6,2,0,4,10,23
318,Trey Lyles\lylestr01,PF,23,DEN,64,2,1120,207,495,.418,51,200,.255,156,295,.529,.470,81,116,.698,44,202,246,87,30,23,68,93,546
319,Scott Machado\machasc01,PG,28,LAL,4,0,19,4,6,.667,1,1,1.000,3,5,.600,.750,1,1,1.000,0,0,0,3,1,0,0,2,10
320,Shelvin Mack\macksh01,PG,28,TOT,57,3,1246,163,403,.404,46,130,.354,117,273,.429,.462,58,84,.690,18,86,104,183,47,4,66,84,430
321,Daryl Macon\maconda01,SG,23,DAL,8,0,90,10,27,.370,5,11,.455,5,16,.313,.463,4,7,.571,2,10,12,7,1,0,6,8,29
322,J.P. Macura\macurjp01,SG,23,CHO,2,0,17,3,9,.333,0,4,.000,3,5,.600,.333,0,0,,0,3,3,2,0,0,0,0,6
323,Ian Mahinmi\mahinia01,C,32,WAS,34,6,498,47,104,.452,3,16,.188,44,88,.500,.466,42,61,.689,48,80,128,25,25,16,21,84,139
324,Thon Maker\makerth01,C-PF,21,TOT,64,5,972,109,268,.407,49,153,.320,60,115,.522,.498,56,84,.667,41,161,202,45,21,51,33,105,323
325,Boban Marjanovic\marjabo01,C,30,TOT,58,12,681,160,260,.615,4,10,.400,156,250,.624,.623,98,131,.748,87,178,265,54,16,27,59,90,422
326,Lauri Markkanen\markkla01,PF,21,CHI,52,51,1682,342,795,.430,120,332,.361,222,463,.479,.506,170,195,.872,74,396,470,75,37,33,85,122,974
327,Jarell Martin\martija01,PF,24,ORL,42,1,328,43,104,.413,20,57,.351,23,47,.489,.510,9,11,.818,11,62,73,18,3,8,11,51,115
328,Frank Mason\masonfr01,PG,24,SAC,38,0,435,71,169,.420,14,64,.219,57,105,.543,.462,39,57,.684,6,37,43,84,16,4,36,34,195
329,Yante Maten\matenya01,PF,22,MIA,2,0,13,1,4,.250,0,1,.000,1,3,.333,.250,0,0,,1,2,3,0,1,0,0,0,2
330,Wesley Matthews\matthwe02,SF-SG,32,TOT,69,68,2091,279,698,.400,150,403,.372,129,295,.437,.507,132,163,.810,32,138,170,160,54,17,91,160,840
331,Luc Mbah a Moute\mbahalu01,PF,32,LAC,4,0,61,8,18,.444,2,6,.333,6,12,.500,.500,2,5,.400,2,5,7,2,1,1,2,8,20
332,Tahjere McCall\mccalta01,SG,24,BRK,1,0,8,2,3,.667,0,1,.000,2,2,1.000,.667,0,1,.000,0,1,1,0,0,0,0,2,4
333,Patrick McCaw\mccawpa01,SG,23,TOT,29,1,397,26,63,.413,9,28,.321,17,35,.486,.484,13,15,.867,7,41,48,29,23,2,17,38,74
334,CJ McCollum\mccolcj01,SG,27,POR,70,70,2375,571,1243,.459,167,445,.375,404,798,.506,.527,159,192,.828,62,220,282,207,55,28,106,172,1468
335,T.J. McConnell\mccontj01,PG,26,PHI,76,3,1470,220,419,.525,14,42,.333,206,377,.546,.542,29,37,.784,28,146,174,258,79,17,91,105,483
336,Doug McDermott\mcderdo01,SF,27,IND,77,1,1340,207,422,.491,84,206,.408,123,216,.569,.590,66,79,.835,17,92,109,67,18,8,42,104,564
337,JaVale McGee\mcgeeja01,C,31,LAL,75,62,1671,400,641,.624,1,12,.083,399,629,.634,.625,96,152,.632,195,371,566,52,47,148,108,208,897
338,Rodney McGruder\mcgruro01,SG,27,MIA,66,45,1550,186,461,.403,79,225,.351,107,236,.453,.489,52,72,.722,60,178,238,112,36,12,64,115,503
339,Alfonzo McKinnie\mckinal01,SF,26,GSW,72,5,1003,134,275,.487,42,118,.356,92,157,.586,.564,27,48,.563,81,166,247,31,18,15,30,134,337
340,Ben McLemore\mclembe01,SG,25,SAC,19,0,158,25,64,.391,17,41,.415,8,23,.348,.523,8,12,.667,3,14,17,4,6,3,5,22,75
341,Jordan McRae\mcraejo01,SG,27,WAS,27,0,333,61,130,.469,10,35,.286,51,95,.537,.508,28,35,.800,6,34,40,30,13,7,15,26,160
342,Jodie Meeks\meeksjo01,SG,31,TOR,8,0,104,21,39,.538,8,18,.444,13,21,.619,.641,1,1,1.000,1,11,12,8,1,1,2,5,51
343,Salah Mejri\mejrisa01,C,32,DAL,36,4,399,55,112,.491,11,34,.324,44,78,.564,.540,20,32,.625,36,95,131,35,10,26,21,55,141
344,De'Anthony Melton\meltode01,PG,20,PHO,50,31,984,100,256,.391,29,95,.305,71,161,.441,.447,21,28,.750,25,109,134,159,68,23,75,113,250
345,Chimezie Metu\metuch01,PF,21,SAS,29,0,145,19,58,.328,0,2,.000,19,56,.339,.328,13,17,.765,9,27,36,13,6,2,15,14,51
346,Khris Middleton\middlkh01,SF,27,MIL,77,77,2393,506,1148,.441,179,474,.378,327,674,.485,.519,216,258,.837,50,411,461,331,80,7,174,172,1407
347,C.J. Miles\milescj01,SF,31,TOT,53,1,856,112,311,.360,67,203,.330,45,108,.417,.468,48,58,.828,13,82,95,36,26,15,30,79,339
348,Darius Miller\milleda01,SF,28,NOP,69,15,1757,189,484,.390,133,364,.365,56,120,.467,.528,56,71,.789,14,114,128,146,40,23,59,165,567
349,Malcolm Miller\millema01,SF,25,TOR,10,0,67,11,26,.423,10,21,.476,1,5,.200,.615,3,4,.750,1,4,5,1,1,1,1,5,35
350,Patty Mills\millspa02,PG,30,SAS,82,1,1908,282,663,.425,159,404,.394,123,259,.475,.545,88,103,.854,24,158,182,245,49,10,93,129,811
351,Paul Millsap\millspa01,PF,33,DEN,70,65,1895,322,665,.484,58,159,.365,264,506,.522,.528,181,249,.727,153,352,505,141,83,54,95,183,883
352,Shake Milton\miltosh01,SG,22,PHI,20,0,268,34,87,.391,14,44,.318,20,43,.465,.471,5,7,.714,9,26,35,18,8,8,6,29,87
353,Nikola Mirotic\mirotni01,PF,27,TOT,46,25,1245,238,542,.439,116,318,.365,122,224,.545,.546,105,124,.847,60,279,339,55,31,34,48,107,697
354,Donovan Mitchell\mitchdo01,SG,22,UTA,77,77,2598,661,1530,.432,188,519,.362,473,1011,.468,.493,319,396,.806,59,257,316,322,106,31,218,208,1829
355,Naz Mitrou-Long\mitrona01,SG,25,UTA,14,0,84,6,20,.300,2,11,.182,4,9,.444,.350,2,2,1.000,1,5,6,15,1,1,8,10,16
356,Malik Monk\monkma01,SG,20,CHO,73,0,1258,227,586,.387,109,330,.330,118,256,.461,.480,90,102,.882,16,121,137,117,37,19,86,106,653
357,Greg Monroe\monrogr01,C,28,TOT,43,2,480,92,189,.487,1,5,.200,91,184,.495,.489,45,72,.625,67,105,172,24,14,8,32,66,230
358,E'Twaun Moore\mooreet01,SG,29,NOP,53,36,1463,256,532,.481,76,176,.432,180,356,.506,.553,45,59,.763,35,92,127,102,40,8,59,112,633
359,Eric Moreland\moreler01,PF,27,TOT,5,0,43,3,7,.429,1,1,1.000,2,6,.333,.500,0,0,,4,16,20,4,1,1,5,9,7
360,Jaylen Morris\morrija01,SG,23,MIL,4,0,29,4,10,.400,1,3,.333,3,7,.429,.450,1,2,.500,0,5,5,4,2,0,1,1,10
361,Marcus Morris\morrima03,PF,29,BOS,75,53,2091,377,844,.447,146,389,.375,231,455,.508,.533,146,173,.844,76,382,458,109,43,25,92,181,1046
362,Markieff Morris\morrima02,PF,29,TOT,58,16,1270,204,484,.421,68,203,.335,136,281,.484,.492,71,92,.772,61,204,265,79,36,22,54,175,547
363,Monte Morris\morrimo01,PG,23,DEN,82,6,1970,346,702,.493,94,227,.414,252,475,.531,.560,65,81,.802,35,159,194,297,73,4,52,102,851
364,Donatas Motiejunas\motiedo01,PF,28,SAS,3,0,13,3,6,.500,0,0,,3,6,.500,.500,0,2,.000,2,1,3,1,0,1,3,6,6
365,Johnathan Motley\motlejo01,PF,23,LAC,22,0,156,39,73,.534,0,3,.000,39,70,.557,.534,24,40,.600,18,33,51,11,5,3,16,27,102
366,Emmanuel Mudiay\mudiaem01,PG,22,NYK,59,42,1607,330,740,.446,69,210,.329,261,530,.492,.493,144,186,.774,33,163,196,228,43,19,140,103,873
367,Jamal Murray\murraja01,PG,21,DEN,75,74,2447,513,1173,.437,152,414,.367,361,759,.476,.502,189,223,.848,65,252,317,363,67,27,158,153,1367
368,Dzanan Musa\musadz01,SG,19,BRK,9,0,39,9,22,.409,1,10,.100,8,12,.667,.432,0,2,.000,1,4,5,2,2,0,4,1,19
369,Mike Muscala\muscami01,PF,27,TOT,64,10,1306,145,361,.402,89,256,.348,56,105,.533,.525,70,85,.824,57,187,244,76,22,38,48,130,449
370,Sviatoslav Mykhailiuk\mykhasv01,SF,21,TOT,42,0,440,46,140,.329,29,89,.326,17,51,.333,.432,12,20,.600,9,27,36,37,14,1,21,25,133
371,Abdel Nader\naderab01,SF,25,OKC,61,1,694,91,215,.423,32,100,.320,59,115,.513,.498,27,36,.750,14,102,116,20,20,12,26,68,241
372,Larry Nance\nancela02,C,26,CLE,67,30,1795,249,479,.520,33,98,.337,216,381,.567,.554,96,134,.716,168,384,552,214,100,40,97,192,627
373,Shabazz Napier\napiesh01,PG,27,BRK,56,2,983,169,435,.389,76,228,.333,93,207,.449,.476,115,138,.833,18,82,100,143,41,16,66,67,529
374,Raul Neto\netora01,PG,26,UTA,37,1,474,74,161,.460,20,60,.333,54,101,.535,.522,28,33,.848,6,56,62,93,14,4,35,49,196
375,Georges Niang\niangge01,PF,25,UTA,59,0,516,86,181,.475,43,105,.410,43,76,.566,.594,20,24,.833,11,76,87,35,10,6,23,57,235
376,Joakim Noah\noahjo01,C,33,MEM,42,1,693,110,213,.516,0,1,.000,110,212,.519,.516,78,109,.716,58,180,238,89,20,31,50,96,298
377,Nerlens Noel\noelne01,C,24,OKC,77,2,1055,162,276,.587,0,0,,162,276,.587,.587,54,79,.684,127,198,325,45,66,96,48,166,378
378,Dirk Nowitzki\nowitdi01,PF,40,DAL,51,20,795,135,376,.359,64,205,.312,71,171,.415,.444,39,50,.780,5,153,158,35,9,18,18,76,373
379,Frank Ntilikina\ntilila01,PG,20,NYK,43,16,904,95,282,.337,33,115,.287,62,167,.371,.395,23,30,.767,12,75,87,121,30,14,56,104,246
380,James Nunnally\nunnaja01,SF,28,TOT,15,0,102,12,34,.353,8,25,.320,4,9,.444,.471,4,4,1.000,0,5,5,7,1,0,1,10,36
381,Jusuf Nurkic\nurkiju01,C,24,POR,72,72,1974,420,826,.508,3,29,.103,417,797,.523,.510,282,365,.773,243,505,748,233,71,103,168,250,1125
382,David Nwaba\nwabada01,SG,26,CLE,51,14,984,126,262,.481,24,75,.320,102,187,.545,.527,58,85,.682,41,122,163,54,36,17,29,106,334
383,Royce O'Neale\onealro01,SF,25,UTA,82,16,1671,163,343,.475,68,176,.386,95,167,.569,.574,32,42,.762,22,263,285,124,54,24,70,172,426
384,Kyle O'Quinn\oquinky01,C,28,IND,45,3,371,69,136,.507,1,12,.083,68,124,.548,.511,17,21,.810,29,90,119,56,9,25,31,68,156
385,Semi Ojeleye\ojelese01,PF,24,BOS,56,3,594,67,158,.424,28,89,.315,39,69,.565,.513,24,39,.615,24,62,86,23,10,4,19,43,186
386,Jahlil Okafor\okafoja01,C,23,NOP,59,24,935,212,362,.586,1,5,.200,211,357,.591,.587,59,89,.663,82,196,278,40,15,40,52,96,484
387,Elie Okobo\okoboel01,PG,21,PHO,53,16,958,114,290,.393,39,132,.295,75,158,.475,.460,37,47,.787,12,86,98,127,32,7,69,109,304
388,Josh Okogie\okogijo01,SG,20,MIN,74,52,1757,196,508,.386,60,215,.279,136,293,.464,.445,118,162,.728,41,177,218,91,88,33,63,166,570
389,Victor Oladipo\oladivi01,SG,26,IND,36,36,1147,249,588,.423,74,216,.343,175,372,.470,.486,103,141,.730,21,181,202,186,60,11,82,72,675
390,Kelly Olynyk\olynyke01,PF,27,MIA,79,36,1812,261,564,.463,113,319,.354,148,245,.604,.563,152,185,.822,72,303,375,140,53,37,114,183,787
391,Cedi Osman\osmande01,SF,23,CLE,76,75,2444,360,844,.427,130,374,.348,230,470,.489,.504,141,181,.779,45,312,357,195,60,11,114,195,991
392,Kelly Oubre\oubreke01,SF,23,TOT,69,19,1935,375,842,.445,108,338,.320,267,504,.530,.510,189,244,.775,71,254,325,84,84,59,103,181,1047
393,Zaza Pachulia\pachuza01,C,34,DET,68,3,878,85,193,.440,0,4,.000,85,189,.450,.440,97,124,.782,99,166,265,91,31,17,57,151,267
394,Jabari Parker\parkeja01,PF,23,TOT,64,17,1724,369,749,.493,61,195,.313,308,554,.556,.533,131,184,.712,79,342,421,152,46,30,151,145,930
395,Tony Parker\parketo01,PG,36,CHO,56,0,1003,213,463,.460,13,51,.255,200,412,.485,.474,91,124,.734,14,69,83,207,21,7,75,53,530
396,Chandler Parsons\parsoch01,SF,30,MEM,25,3,496,68,182,.374,29,94,.309,39,88,.443,.453,22,25,.880,4,66,70,43,19,5,32,45,187
397,Patrick Patterson\pattepa01,PF,29,OKC,63,5,861,82,219,.374,46,137,.336,36,82,.439,.479,19,30,.633,42,105,147,31,16,13,22,46,229
398,Justin Patton\pattoju01,C,21,PHI,3,0,21,2,7,.286,0,2,.000,2,5,.400,.286,1,2,.500,2,4,6,3,2,0,0,5,5
399,Chris Paul\paulch01,PG,33,HOU,58,58,1857,302,720,.419,127,355,.358,175,365,.479,.508,175,203,.862,36,229,265,473,114,18,152,146,906
400,Cameron Payne\payneca01,PG,24,TOT,40,13,712,96,223,.430,25,84,.298,71,139,.511,.487,33,41,.805,13,59,72,106,28,9,45,64,250
401,Elfrid Payton\paytoel01,PG,24,NOP,42,42,1250,179,412,.434,33,105,.314,146,307,.476,.475,55,74,.743,49,171,220,320,44,17,112,81,446
402,Gary Payton\paytoga02,PG,26,WAS,3,0,16,5,8,.625,1,2,.500,4,6,.667,.688,0,0,,1,1,2,4,3,1,1,2,11
403,Theo Pinson\pinsoth01,SG,23,BRK,18,0,211,25,73,.342,12,46,.261,13,27,.481,.425,19,22,.864,4,32,36,21,6,0,18,15,81
404,Mason Plumlee\plumlma01,C,28,DEN,82,17,1731,262,442,.593,2,10,.200,260,432,.602,.595,111,198,.561,165,359,524,243,66,76,126,252,637
405,Miles Plumlee\plumlmi01,C,30,ATL,18,0,173,32,48,.667,0,0,,32,48,.667,.667,16,30,.533,16,23,39,17,6,4,10,14,80
406,Jakob Poeltl\poeltja01,C,23,SAS,77,24,1273,187,290,.645,0,0,,187,290,.645,.645,49,92,.533,178,232,410,93,29,68,48,124,423
407,Quincy Pondexter\pondequ01,SF,30,SAS,53,0,292,29,58,.500,6,18,.333,23,40,.575,.552,34,42,.810,8,38,46,24,11,1,13,24,98
408,Otto Porter\porteot01,SF,25,TOT,56,43,1683,299,643,.465,104,256,.406,195,387,.504,.546,78,96,.813,54,260,314,120,82,31,65,108,780
409,Bobby Portis\portibo01,PF,23,TOT,50,28,1299,279,628,.444,75,191,.393,204,437,.467,.504,77,97,.794,109,294,403,72,35,20,74,145,710
410,Dwight Powell\poweldw01,C,27,DAL,77,22,1662,290,486,.597,39,127,.307,251,359,.699,.637,196,254,.772,140,271,411,112,44,50,67,201,815
411,Norman Powell\powelno01,SG,25,TOR,60,3,1126,193,400,.483,68,170,.400,125,230,.543,.568,62,75,.827,16,123,139,91,39,13,65,96,516
412,Alex Poythress\poythal01,PF,25,ATL,21,1,305,40,81,.494,9,23,.391,31,58,.534,.549,18,29,.621,29,47,76,17,4,10,13,47,107
413,Zhou Qi\qizh01,PF,23,HOU,1,0,1,1,1,1.000,0,0,,1,1,1.000,1.000,0,0,,0,0,0,0,0,0,0,0,2
414,Ivan Rabb\rabbiv01,PF,21,MEM,49,13,721,116,212,.547,3,15,.200,113,197,.574,.554,49,69,.710,70,136,206,54,17,14,35,90,284
415,Chasson Randle\randlch01,PG,25,WAS,49,2,743,91,217,.419,46,115,.400,45,102,.441,.525,43,62,.694,10,46,56,97,25,3,43,91,271
416,Julius Randle\randlju01,PF,24,NOP,73,49,2232,571,1089,.524,67,195,.344,504,894,.564,.555,356,487,.731,162,472,634,229,52,45,208,246,1565
417,J.J. Redick\redicjj01,SG,34,PHI,76,63,2379,452,1027,.440,240,605,.397,212,422,.502,.557,228,255,.894,20,166,186,206,32,17,101,129,1372
418,Davon Reed\reedda01,SG,23,IND,10,0,47,5,12,.417,2,4,.500,3,8,.375,.500,0,0,,2,4,6,3,1,0,1,3,12
419,Cameron Reynolds\reynoca01,SG,23,MIN,19,0,259,33,78,.423,21,51,.412,12,27,.444,.558,8,9,.889,4,27,31,13,6,2,5,26,95
420,Josh Richardson\richajo01,SG,25,MIA,73,73,2539,423,1026,.412,164,460,.357,259,566,.458,.492,199,231,.861,54,209,263,298,79,34,113,200,1209
421,Malachi Richardson\richama01,SG,23,TOR,22,0,103,9,29,.310,8,25,.320,1,4,.250,.448,4,5,.800,2,11,13,0,1,0,8,13,30
422,Austin Rivers\riverau01,SG,26,TOT,76,15,2028,232,572,.406,104,327,.318,128,245,.522,.497,50,95,.526,25,137,162,167,47,23,68,207,618
423,Devin Robinson\robinde01,SF,23,WAS,7,0,95,19,32,.594,0,2,.000,19,30,.633,.594,9,14,.643,6,14,20,6,4,6,2,11,47
424,Duncan Robinson\robindu01,PF,24,MIA,15,1,161,18,46,.391,10,35,.286,8,11,.727,.500,4,6,.667,2,17,19,5,5,0,4,11,50
425,Glenn Robinson\robingl02,SF,25,DET,47,18,610,74,176,.420,18,62,.290,56,114,.491,.472,32,40,.800,17,54,71,21,14,8,18,45,198
426,Jerome Robinson\robinje01,SG,21,LAC,33,0,320,44,110,.400,18,57,.316,26,53,.491,.482,6,9,.667,3,38,41,19,11,3,13,46,112
427,Mitchell Robinson\robinmi01,C,20,NYK,66,19,1360,202,291,.694,0,0,,202,291,.694,.694,81,135,.600,177,246,423,37,52,161,35,217,485
428,Rajon Rondo\rondora01,PG,32,LAL,46,29,1369,175,432,.405,51,142,.359,124,290,.428,.464,23,36,.639,34,209,243,367,57,7,127,100,424
429,Derrick Rose\rosede01,PG,30,MIN,51,13,1392,363,753,.482,54,146,.370,309,607,.509,.518,137,160,.856,33,107,140,220,31,12,82,57,917
430,Terrence Ross\rosste01,SG,27,ORL,81,0,2150,440,1027,.428,217,566,.383,223,461,.484,.534,126,144,.875,27,253,280,135,72,29,90,119,1223
431,Terry Rozier\roziete01,PG,24,BOS,79,14,1791,258,666,.387,119,337,.353,139,329,.422,.477,73,93,.785,32,275,307,231,68,21,68,101,708
432,Ricky Rubio\rubiori01,PG,28,UTA,68,67,1899,295,730,.404,79,254,.311,216,476,.454,.458,195,228,.855,33,210,243,416,91,10,180,180,864
433,D'Angelo Russell\russeda01,PG,22,BRK,81,81,2448,659,1517,.434,234,635,.369,425,882,.482,.512,160,205,.780,53,262,315,563,100,20,253,141,1712
434,Domantas Sabonis\sabondo01,C,22,IND,74,5,1838,413,700,.590,9,17,.529,404,683,.592,.596,208,291,.715,186,504,690,212,48,30,160,239,1043
435,Brandon Sampson\sampsbr01,SG,21,CHI,14,2,214,28,60,.467,11,29,.379,17,31,.548,.558,4,6,.667,3,13,16,10,8,3,12,19,71
436,JaKarr Sampson\sampsja02,SF,25,CHI,4,0,127,29,54,.537,5,14,.357,24,40,.600,.583,17,21,.810,5,27,32,4,4,3,4,8,80
437,Dario Saric\saricda01,PF,24,TOT,81,41,2023,304,696,.437,118,323,.365,186,373,.499,.522,132,150,.880,126,331,457,127,45,9,97,182,858
438,Tomas Satoransky\satorto01,PG,27,WAS,80,54,2164,257,530,.485,64,162,.395,193,368,.524,.545,131,160,.819,82,197,279,399,82,13,120,172,709
439,Dennis Schroder\schrode01,PG,25,OKC,79,14,2314,457,1104,.414,124,364,.341,333,740,.450,.470,186,227,.819,38,246,284,323,65,12,172,189,1224
440,Mike Scott\scottmi01,PF,30,TOT,79,3,1395,168,420,.400,101,252,.401,67,168,.399,.520,22,33,.667,43,233,276,66,26,13,44,156,459
441,Thabo Sefolosha\sefolth01,SF,34,UTA,50,2,609,71,149,.477,34,78,.436,37,71,.521,.591,14,22,.636,8,115,123,27,43,5,25,41,190
442,Wayne Selden\seldewa01,SG,24,TOT,75,13,1439,196,483,.406,55,174,.316,141,309,.456,.463,67,92,.728,37,143,180,109,33,13,79,131,514
443,Collin Sexton\sextoco01,PG,20,CLE,82,72,2605,519,1206,.430,119,296,.402,400,910,.440,.480,214,255,.839,57,179,236,243,44,6,185,186,1371
444,Landry Shamet\shamela01,SG,21,TOT,79,27,1802,240,557,.431,167,396,.422,73,161,.453,.581,75,93,.806,21,113,134,117,37,10,45,155,722
445,Iman Shumpert\shumpim01,SG,28,TOT,62,41,1481,167,446,.374,95,273,.348,72,173,.416,.481,36,45,.800,27,156,183,112,59,24,50,127,465
446,Pascal Siakam\siakapa01,PF,24,TOR,80,79,2548,519,945,.549,79,214,.369,440,731,.602,.591,237,302,.785,124,425,549,248,73,52,154,241,1354
447,Jordan Sibert\siberjo01,SG,26,ATL,1,0,4,1,1,1.000,1,1,1.000,0,0,,1.500,0,0,,0,0,0,0,0,0,0,0,3
448,Ben Simmons\simmobe01,PG,22,PHI,79,79,2700,540,960,.563,0,6,.000,540,954,.566,.563,257,428,.600,172,525,697,610,112,61,274,209,1337
449,Jonathon Simmons\simmojo02,SG-SF,29,TOT,56,9,1064,133,350,.380,28,104,.269,105,246,.427,.420,72,97,.742,27,99,126,128,29,15,68,89,366
450,Kobi Simmons\simmoko01,PG,21,CLE,1,0,2,0,0,,0,0,,0,0,,,0,0,,0,0,0,0,0,0,0,0,0
451,Anfernee Simons\simonan01,SG,19,POR,20,1,141,28,63,.444,10,29,.345,18,34,.529,.524,9,16,.563,3,10,13,13,1,0,11,9,75
452,Marcus Smart\smartma01,SG,24,BOS,80,60,2200,239,567,.422,126,346,.364,113,221,.511,.533,104,129,.806,57,177,234,321,143,28,123,201,708
453,Dennis Smith\smithde03,PG,21,TOT,53,50,1508,278,650,.428,67,208,.322,211,442,.477,.479,99,156,.635,32,123,155,252,67,20,154,129,722
454,Ish Smith\smithis01,PG,30,DET,56,0,1251,205,489,.419,44,135,.326,161,354,.455,.464,47,62,.758,23,122,145,203,28,11,61,109,501
455,J.R. Smith\smithjr01,SG,33,CLE,11,4,222,27,79,.342,12,39,.308,15,40,.375,.418,8,10,.800,0,18,18,21,11,3,11,19,74
456,Jason Smith\smithja02,PF-C,32,TOT,20,1,190,21,59,.356,9,26,.346,12,33,.364,.432,14,16,.875,16,36,52,14,3,7,13,30,65
457,Zhaire Smith\smithzh01,SG,19,PHI,6,2,111,14,34,.412,6,16,.375,8,18,.444,.500,6,8,.750,3,10,13,10,2,2,6,8,40
458,Tony Snell\snellto01,SF,27,MIL,74,12,1304,163,361,.452,81,204,.397,82,157,.522,.564,37,42,.881,29,128,157,68,26,18,23,90,444
459,Ray Spalding\spaldra01,PF,21,TOT,14,3,148,25,47,.532,0,3,.000,25,44,.568,.532,4,12,.333,15,33,48,5,9,8,9,23,54
460,Omari Spellman\spellom01,PF,21,ATL,46,11,805,98,244,.402,44,128,.344,54,116,.466,.492,32,45,.711,72,122,194,47,26,25,31,67,272
461,Nik Stauskas\stausni01,SG,25,TOT,68,0,1015,136,338,.402,70,188,.372,66,150,.440,.506,57,64,.891,18,109,127,81,21,7,51,50,399
462,D.J. Stephens\stephdj01,SG,28,MEM,1,0,7,1,2,.500,0,0,,1,2,.500,.500,0,0,,0,0,0,0,1,0,1,0,2
463,Lance Stephenson\stephla01,SG,28,LAL,68,3,1123,184,432,.426,73,197,.371,111,235,.472,.510,50,73,.685,32,183,215,140,41,7,86,111,491
464,Edmond Sumner\sumneed01,PG,23,IND,23,2,210,22,64,.344,7,27,.259,15,37,.405,.398,15,24,.625,9,15,24,10,12,5,10,26,66
465,Caleb Swanigan\swanica01,PF,21,TOT,21,0,178,18,53,.340,1,7,.143,17,46,.370,.349,6,9,.667,17,47,64,11,6,1,18,28,43
466,Jayson Tatum\tatumja01,SF,20,BOS,79,79,2455,466,1036,.450,116,311,.373,350,725,.483,.506,195,228,.855,70,407,477,168,84,57,122,168,1243
467,Jeff Teague\teaguje01,PG,30,MIN,42,41,1264,176,416,.423,35,105,.333,141,311,.453,.465,123,153,.804,16,90,106,343,43,18,97,90,510
468,Garrett Temple\templga01,SG,32,TOT,75,55,2040,208,493,.422,90,264,.341,118,229,.515,.513,80,107,.748,28,188,216,106,76,30,70,204,586
469,Milos Teodosic\teodomi01,PG,31,LAC,15,0,150,17,40,.425,10,27,.370,7,13,.538,.550,4,7,.571,3,13,16,32,3,1,21,27,48
470,Jared Terrell\terreja01,SG,23,MIN,14,0,111,12,39,.308,4,17,.235,8,22,.364,.359,3,6,.500,1,5,6,12,3,2,10,16,31
471,Emanuel Terry\terryem01,PF,22,TOT,3,0,23,4,7,.571,0,0,,4,7,.571,.571,2,4,.500,3,4,7,2,3,0,2,4,10
472,Daniel Theis\theisda01,C,26,BOS,66,2,908,146,266,.549,26,67,.388,120,199,.603,.598,56,76,.737,87,138,225,68,21,42,33,161,374
473,Isaiah Thomas\thomais02,SG,29,DEN,12,0,181,34,99,.343,12,43,.279,22,56,.393,.404,17,27,.630,5,8,13,23,5,1,18,17,97
474,Khyri Thomas\thomakh01,SG,22,DET,26,0,195,22,69,.319,10,35,.286,12,34,.353,.391,7,11,.636,4,16,20,8,7,5,4,22,61
475,Lance Thomas\thomala01,PF,30,NYK,46,17,783,78,197,.396,22,79,.278,56,118,.475,.452,27,36,.750,21,96,117,27,17,7,24,83,205
476,Klay Thompson\thompkl01,SG,28,GSW,78,78,2652,655,1402,.467,241,599,.402,414,803,.516,.553,129,158,.816,37,262,299,186,84,47,115,157,1680
477,Tristan Thompson\thomptr01,C,27,CLE,43,40,1198,201,380,.529,0,0,,201,380,.529,.529,68,106,.642,173,265,438,86,28,16,59,89,470
478,Sindarius Thornwell\thornsi01,SG,24,LAC,64,1,313,17,49,.347,3,15,.200,14,34,.412,.378,25,34,.735,5,39,44,18,14,7,20,41,62
479,Anthony Tolliver\tollian01,PF,33,MIN,65,0,1079,99,259,.382,81,215,.377,18,44,.409,.539,47,60,.783,15,162,177,46,17,21,36,91,326
480,Karl-Anthony Towns\townska01,C,23,MIN,77,77,2545,681,1314,.518,142,355,.400,539,959,.562,.572,376,450,.836,263,691,954,259,67,125,240,292,1880
481,Gary Trent\trentga02,SG,20,POR,15,1,111,16,50,.320,5,21,.238,11,29,.379,.370,3,7,.429,1,10,11,5,1,2,4,4,40
482,Allonzo Trier\trieral01,SG,23,NYK,64,3,1459,232,518,.448,52,132,.394,180,386,.466,.498,179,223,.803,31,166,197,119,28,14,116,117,695
483,P.J. Tucker\tuckepj01,PF,33,HOU,82,82,2802,207,523,.396,146,387,.377,61,136,.449,.535,41,59,.695,121,358,479,96,132,39,63,252,601
484,Evan Turner\turneev01,PG,30,POR,73,2,1605,204,443,.460,11,52,.212,193,391,.494,.473,75,106,.708,37,291,328,283,33,18,114,110,494
485,Myles Turner\turnemy01,C,22,IND,74,74,2119,380,780,.487,76,196,.388,304,584,.521,.536,148,201,.736,101,430,531,115,60,199,100,195,984
486,Ekpe Udoh\udohek01,C,31,UTA,51,1,320,50,72,.694,0,0,,50,72,.694,.694,19,30,.633,27,63,90,28,10,31,13,36,119
487,Tyler Ulis\ulisty01,PG,23,CHI,1,0,1,0,0,,0,0,,0,0,,,0,0,,0,0,0,0,0,0,0,0,0
488,Jonas Valanciunas\valanjo01,C,26,TOT,49,27,1091,301,538,.559,14,48,.292,287,490,.586,.572,147,185,.795,106,313,419,70,19,53,90,146,763
489,Jarred Vanderbilt\vandeja01,PF,19,DEN,17,0,69,9,19,.474,0,1,.000,9,18,.500,.474,6,10,.600,7,16,23,3,6,1,8,8,24
490,Fred VanVleet\vanvlfr01,PG,24,TOR,64,28,1760,246,600,.410,112,296,.378,134,304,.441,.503,97,115,.843,21,146,167,307,57,20,82,110,701
491,Noah Vonleh\vonleno01,PF,23,NYK,68,57,1722,207,440,.470,46,137,.336,161,303,.531,.523,111,156,.712,113,415,528,129,46,51,88,174,571
492,Nikola Vucevic\vucevni01,C,28,ORL,80,80,2510,701,1354,.518,84,231,.364,617,1123,.549,.549,179,227,.789,224,736,960,307,81,89,159,157,1665
493,Dwyane Wade\wadedw01,SG,37,MIA,72,2,1885,416,960,.433,86,261,.330,330,699,.472,.478,165,233,.708,69,216,285,301,59,38,166,118,1083
494,Moritz Wagner\wagnemo01,C,21,LAL,43,5,446,71,171,.415,22,77,.286,49,94,.521,.480,43,53,.811,17,68,85,24,11,13,39,57,207
495,Dion Waiters\waitedi01,SG,27,MIA,44,28,1138,198,478,.414,109,289,.377,89,189,.471,.528,22,44,.500,7,109,116,121,29,9,64,72,527
496,Kemba Walker\walkeke02,PG,28,CHO,82,82,2863,731,1684,.434,260,731,.356,471,953,.494,.511,380,450,.844,52,309,361,484,102,34,211,131,2102
497,Lonnie Walker\walkelo01,SG,20,SAS,17,0,118,16,46,.348,5,13,.385,11,33,.333,.402,8,10,.800,0,17,17,9,7,3,4,7,45
498,John Wall\walljo01,PG,28,WAS,32,32,1104,245,552,.444,51,169,.302,194,383,.507,.490,122,175,.697,15,101,116,279,49,29,121,71,663
499,Tyrone Wallace\wallaty01,PG,24,LAC,62,0,628,92,217,.424,4,19,.211,88,198,.444,.433,30,57,.526,20,81,101,42,21,7,36,83,218
500,Taurean Waller-Prince\princta02,SF,24,ATL,55,47,1552,262,594,.441,123,315,.390,139,279,.498,.545,95,116,.819,22,177,199,118,53,19,100,141,742
501,Brad Wanamaker\wanambr01,PG,29,BOS,36,0,343,50,105,.476,16,39,.410,34,66,.515,.552,24,28,.857,3,38,41,56,12,2,19,34,140
502,T.J. Warren\warretj01,SF,25,PHO,43,36,1360,297,611,.486,77,180,.428,220,431,.510,.549,101,124,.815,31,143,174,64,51,29,52,119,772
503,Julian Washburn\washbju01,SF,27,MEM,18,3,254,16,48,.333,5,24,.208,11,24,.458,.385,3,4,.750,8,33,41,14,13,2,7,16,40
504,Yuta Watanabe\watanyu01,SF,24,MEM,15,0,174,15,51,.294,2,16,.125,13,35,.371,.314,7,10,.700,4,27,31,8,4,1,6,11,39
505,Thomas Welsh\welshth01,C,22,DEN,11,0,36,7,13,.538,3,7,.429,4,6,.667,.654,1,2,.500,0,4,4,5,0,0,1,3,18
506,Russell Westbrook\westbru01,PG,30,OKC,73,73,2630,630,1473,.428,119,411,.290,511,1062,.481,.468,296,451,.656,109,698,807,784,142,33,325,245,1675
507,Derrick White\whitede01,PG,24,SAS,67,55,1728,260,543,.479,48,142,.338,212,401,.529,.523,95,123,.772,35,212,247,263,67,47,97,145,663
508,Okaro White\whiteok01,PF,26,WAS,3,0,6,0,2,.000,0,2,.000,0,0,,.000,0,0,,1,1,2,0,0,0,0,0,0
509,Hassan Whiteside\whiteha01,C,29,MIA,72,53,1674,388,680,.571,2,16,.125,386,664,.581,.572,109,243,.449,257,560,817,56,46,136,97,192,887
510,Andrew Wiggins\wiggian01,SF,23,MIN,73,73,2543,498,1209,.412,118,348,.339,380,861,.441,.461,207,296,.699,83,269,352,184,70,48,138,153,1321
511,Alan Williams\willial03,PF,26,BRK,5,0,26,8,13,.615,0,1,.000,8,12,.667,.615,2,4,.500,4,15,19,3,1,0,1,2,18
512,C.J. Williams\willicj01,SG,28,MIN,15,0,128,17,35,.486,5,16,.313,12,19,.632,.557,0,1,.000,1,7,8,12,6,0,5,16,39
513,Johnathan Williams\willijo04,C,23,LAL,24,0,372,65,110,.591,0,2,.000,65,108,.602,.591,27,48,.563,48,51,99,13,8,7,16,62,157
514,Kenrich Williams\willike04,SF,24,NOP,46,29,1079,107,279,.384,52,156,.333,55,123,.447,.477,13,19,.684,55,164,219,83,45,19,36,95,279
515,Lou Williams\willilo02,SG,32,LAC,75,1,1993,484,1138,.425,105,291,.361,379,847,.447,.471,425,485,.876,40,182,222,402,57,11,181,80,1498
516,Marvin Williams\willima02,PF,32,CHO,75,75,2133,275,652,.422,140,382,.366,135,270,.500,.529,66,86,.767,76,331,407,92,71,61,47,156,756
517,Robert Williams\williro04,C,21,BOS,32,2,283,36,51,.706,0,0,,36,51,.706,.706,9,15,.600,27,54,81,7,9,40,10,36,81
518,Troy Williams\willitr02,SF,24,SAC,21,0,312,44,98,.449,14,44,.318,30,54,.556,.520,9,15,.600,12,47,59,11,10,8,9,37,111
519,D.J. Wilson\wilsodj01,PF,22,MIL,48,3,882,104,251,.414,46,127,.362,58,124,.468,.506,26,47,.553,45,177,222,52,18,20,32,85,280
520,Justise Winslow\winslju01,SF,22,MIA,66,52,1959,324,749,.433,96,256,.375,228,493,.462,.497,86,137,.628,63,292,355,282,72,19,142,177,830
521,Christian Wood\woodch01,PF,23,TOT,21,2,251,61,117,.521,9,26,.346,52,91,.571,.560,41,56,.732,17,66,83,8,7,10,17,17,172
522,Delon Wright\wrighde01,PG,26,TOT,75,13,1699,242,558,.434,50,168,.298,192,390,.492,.478,119,150,.793,68,198,266,248,88,30,77,103,653
523,Guerschon Yabusele\yabusgu01,PF,23,BOS,41,1,251,35,77,.455,9,28,.321,26,49,.531,.513,15,22,.682,23,30,53,15,8,7,15,32,94
524,Nick Young\youngni01,SG,33,DEN,4,0,37,3,9,.333,3,8,.375,0,1,.000,.500,0,0,,0,1,1,2,0,1,2,4,9
525,Thaddeus Young\youngth01,PF,30,IND,81,81,2489,443,841,.527,51,146,.349,392,695,.564,.557,87,135,.644,192,331,523,204,123,36,123,194,1024
526,Trae Young\youngtr01,PG,20,ATL,81,81,2503,525,1256,.418,156,482,.324,369,774,.477,.480,343,414,.829,64,237,301,653,72,15,308,140,1549
527,Cody Zeller\zelleco01,C,26,CHO,49,47,1243,190,345,.551,6,22,.273,184,323,.570,.559,111,141,.787,110,223,333,102,38,41,62,164,497
528,Tyler Zeller\zellety01,C,29,TOT,6,1,93,16,30,.533,0,1,.000,16,29,.552,.533,14,18,.778,11,13,24,4,1,3,4,20,46
529,Ante Zizic\zizican01,C,22,CLE,59,25,1082,183,331,.553,0,0,,183,331,.553,.553,93,132,.705,108,212,320,53,13,22,61,113,459
530,Ivica Zubac\zubaciv01,C,21,TOT,59,37,1040,212,379,.559,0,0,,212,379,.559,.559,101,126,.802,115,247,362,63,14,51,70,137,525